>take all
copy of Research Robotics: Taken.
grey fatigues: Taken.
keycard: Taken.
mobile phone: Taken.

[Your score has just gone up by two points.]

>test awaken
(Testing.)

>[1] take all
There are none at all available!

>[2] put on clothes
You put on the grey fatigues.

>[3] turn off alarm
You switch the alarm clock off.

>[4] north.
(first getting off your bunk bed)
(first opening the hatch)

Mess Hall
The Mess Hall is more properly a bar repurposed at mealtimes for eating, and west of Offices.

On the bar are prepared plates, pint glasses and some beer taps.

You can also see Bart the Bartender here.

Bart the Bartender tends to the stovetop.

>test all
(Testing.)

>[1] test awaken
(Testing.)

>[2] take all
prepared plates: You take a plate from the bar.
pint glasses: You take a pint glass from the bar.

Bart the Bartender scrubs the stovetop.

>[3] put on clothes
You're already wearing those!

Bart the Bartender tends to the stovetop.

>[4] turn off alarm
You can't see any such thing.

>[5] north.
You can't go that way.

Bart the Bartender scrubs the prepared plates.

>[6] test breakfast
(Testing.)

>[7] take plate
You already have that.

Bart the Bartender prepares the beer taps.

>[8] take glass
You already have that.

Bart the Bartender scrubs the stovetop.

>[9] eat pancake
(first taking the pancake)
You eat the pancake. Not bad.

Bart the Bartender cleans the beer taps.

>[10] eat egg
(first taking the egg)
You eat the egg. Not bad.

Bart the Bartender washes the stovetop.

>[11] eat bacon
(first taking the slice of bacon)
You eat the slice of bacon. Not bad.

Bart the Bartender tends to the prepared plates.

>[12] eat toast
(first taking the slice of toast)
You eat the slice of toast. Not bad.

Bart the Bartender washes the beer taps.

>[13] drink orange juice
You drink the orange juice. Refreshing.

Bart the Bartender cleans the beer taps.

>[14] drop plate and glass
prepared plate: Dropped.
pint glass: Dropped.

Bart the Bartender tends to the beer taps.

>[15] turn off bart
You switch Bart the Bartender off.

>[16] east.

Offices
You pass through Offices, with Catwalk to the north and Operations to the east.

You can see a computer terminal (closed) here.

Your mobile phone buzzes.

>[17] test duties.
(Testing.)

>[18] look at mobile
Text message: "Today's duties:
- Check status of robots on computer terminal in Offices.
- Activate robot workers in Housing Unit.
- Gear up in Ready Room."

A scientist arrives from Operations.

>[19] unlock terminal with keycard
You unlock the computer terminal.

>[20] open terminal
You open the computer terminal, revealing ROBOTS file.

A scientist heads to Operations.

>[21] read robots.
Robot Locations
Humanoid 1 Housing Unit
Humanoid 2 Housing Unit
Humanoid 3 UNKNOWN
Humanoid 4 Housing Unit

>e
Operations
The clicks and beeps of the supercomputer here match the blinking lights and gauges. West to Offices.

You can see a scientist and a supercomputer here.

Your mobile phone buzzes.

A scientist heads to Offices.

>w
Offices
You pass through Offices, with Catwalk to the north and Operations to the east.

You can see a scientist and a computer terminal (in which is ROBOTS file) here.

Your mobile phone buzzes.

>n
Catwalk
Your shoes jingle along the metal surface between the railings leading west to Ready Room and east to Garage.

Your mobile phone buzzes.

A scientist arrives from Offices.

>w
Ready Room
Your gear is stored in the lockers. Housing Unit to west, Catwalk east.

You can see some lockers (closed) here.

Your mobile phone buzzes.

>open lockers
You open the lockers, revealing a thick outdoor gear and an EMP Grenade.

Your mobile phone buzzes.

A scientist arrives from Catwalk.

>wear gear
(first taking the thick outdoor gear)
You put on the thick outdoor gear.

Your mobile phone buzzes.

>take all
EMP Grenade: Taken.

Your mobile phone buzzes.

A scientist heads to Catwalk.

>e
Catwalk
Your shoes bang along the metal surface between the railings leading west to Ready Room and east to Garage.

You can see a scientist here.

Your mobile phone buzzes.

>s
Offices
You pass through Offices, with Catwalk to the north and Operations to the east.

You can see a computer terminal (in which is ROBOTS file) here.

Your mobile phone buzzes.

>e
Operations
The clicks and beeps of the supercomputer here match the blinking lights and gauges. West to Offices.

You can see a supercomputer here.

Your mobile phone buzzes.

>turn off supercomputer
Your mobile phone buzzes.

>take off gear
You take off the thick outdoor gear.

Your mobile phone buzzes.

It's kinda cold out here.

>w
Offices
You pass through Offices, with Catwalk to the north and Operations to the east.

You can see a computer terminal (in which is ROBOTS file) here.

Your mobile phone buzzes.

You are getting cold.

>b
That's not a verb I recognize.

>n
Catwalk
Your shoes clank along the metal surface between the railings leading west to Ready Room and east to Garage.

Your mobile phone buzzes.

You can't feel your toes.

>read phone
Text message: "Alert! A Humanoid worker is missing. Investigate Housing Unit."

You are getting cold.

It is now pitch dark in here!

>s
Darkness
It is pitch dark, and you can't see a thing.

It's kinda cold out here.

    *** You have died of hypothermia. ***

In that game you scored 2 out of a possible 0, in 37 turns.

Would you like to RESTART, RESTORE a saved game, QUIT or UNDO the last command?

* * *

You awaken.

Antarctic Ruse
An Interactive Fiction by Robert Dionne
Release 1 / Serial number 140406 / Inform 7 build 6G60 (I6/v6.32 lib 6/12N) SD

Sleeping Quarters (on your bunk bed)
You are in your bunk bed in Sleeping Quarters. The smell of warm breakfast wafts through the northern hatch. Your alarm clock buzzes loudly.

On the other bunks are some sleeping crew.

On your night stand are an alarm clock, a keycard and a mobile phone.

On your bunk bed you can see a copy of Research Robotics and some grey fatigues.

>test awaken
(Testing.)

>[1] take all
copy of Research Robotics: Taken.
grey fatigues: Taken.
keycard: Taken.
mobile phone: Taken.

[Your score has just gone up by two points.]

>[2] put on clothes
You put on the grey fatigues.

>[3] turn off alarm
You switch the alarm clock off.

>[4] north.
(first getting off your bunk bed)
(first opening the hatch)

Mess Hall
The Mess Hall is more properly a bar repurposed at mealtimes for eating, and west of Offices.

On the bar are prepared plates, pint glasses and some beer taps.

You can also see Bart the Bartender here.

Bart the Bartender scrubs the stovetop.

>test breakfast
(Testing.)

>[1] take plate
You take a plate from the bar.

Bart the Bartender prepares the prepared plates.

>[2] take glass
You take a pint glass from the bar.

Bart the Bartender tends to the beer taps.

>[3] eat pancake
(first taking the pancake)
You eat the pancake. Not bad.

Bart the Bartender prepares the pint glasses.

>[4] eat egg
(first taking the egg)
You eat the egg. Not bad.

Bart the Bartender cleans the pint glasses.

>[5] eat bacon
(first taking the slice of bacon)
You eat the slice of bacon. Not bad.

Bart the Bartender tends to the pint glasses.

>[6] eat toast
(first taking the slice of toast)
You eat the slice of toast. Not bad.

Bart the Bartender scrubs the stovetop.

>[7] drink orange juice
You drink the orange juice. Refreshing.

Bart the Bartender washes the stovetop.

>[8] drop plate and glass
prepared plate: Dropped.
pint glass: Dropped.

Bart the Bartender cleans the prepared plates.

>[9] turn off bart
You switch Bart the Bartender off.

>[10] east.

Offices
You pass through Offices, with Catwalk to the north and Operations to the east.

You can see a computer terminal (closed) here.

Your mobile phone buzzes.

>est duties
That's not a verb I recognize.

>test duties
(Testing.)

>[1] look at mobile
Text message: "Today's duties:
- Check status of robots on computer terminal in Offices.
- Activate robot workers in Housing Unit.
- Gear up in Ready Room."

>[2] unlock terminal with keycard
You unlock the computer terminal.

>[3] open terminal
You open the computer terminal, revealing ROBOTS file.

>[4] read robots.
Robot Locations
Humanoid 1 Housing Unit
Humanoid 2 Housing Unit
Humanoid 3 UNKNOWN
Humanoid 4 Housing Unit

>e
Operations
The clicks and beeps of the supercomputer here match the blinking lights and gauges. West to Offices.

You can see a supercomputer here.

Your mobile phone buzzes.

>read phone
Text message: "Alert! A Humanoid worker is missing. Investigate Housing Unit."

>w
Offices
You pass through Offices, with Catwalk to the north and Operations to the east.

You can see a computer terminal (in which is ROBOTS file) here.

>n
Catwalk
Your shoes clomp along the metal surface between the railings leading west to Ready Room and east to Garage.

You can see a scientist here.

A scientist heads to Ready Room.

>w
Ready Room
Your gear is stored in the lockers. Housing Unit to west, Catwalk east.

You can see a scientist and some lockers (closed) here.

>w
Housing Unit
You can see Humanoid 1, Humanoid 2 and Humanoid 4 here.

A scientist arrives from Ready Room.

>e
Ready Room
Your gear is stored in the lockers. Housing Unit to west, Catwalk east.

You can see some lockers (closed) here.

Your mobile phone buzzes.

>read phone
Text message: "Urgent! Suit up in Ready Room. Track down rogue Humanoid 3 outside via Garage."

A scientist arrives from Housing Unit.

>open lockers
You open the lockers, revealing a thick outdoor gear and an EMP Grenade.

>take all
thick outdoor gear: Taken.
EMP Grenade: Taken.

A scientist heads to Housing Unit.

>put on gear
You put on the thick outdoor gear.

>e
Catwalk
Your shoes bang along the metal surface between the railings leading west to Ready Room and east to Garage.

>e
Garage
The SnowCat lies dormant in the Garage. Outside to north.

You can see some empty fuel canisters and SnowCat (empty) here.

* * *

>enter snowcat
You get into SnowCat.

>look
Garage (in SnowCat)
The SnowCat roars to life in the Garage. Outside to north.

You can see some empty fuel canisters here.

>look at snowcat
A rugged, tracked vehicle with enclosed cab for navigating the treacherous climate outside.

* * *

>n
You can't go that way.

Bart the Bartender prepares the stovetop.

>e
Offices
You pass through Offices, with Catwalk to the north and Operations to the east.

You can see a computer terminal (closed) here.

Your mobile phone buzzes.

A scientist arrives from Operations.

>n
Catwalk
Your shoes clomp along the metal surface between the railings leading west to Ready Room and east to Garage.

Your mobile phone buzzes.

>w
Ready Room
Your gear is stored in the lockers.

You can see some lockers (closed) here.

Your mobile phone buzzes.

>open lockers
You open the lockers, revealing Thick outdoor gear and EMP Grenade.

Your mobile phone buzzes.

>read phone
Text message: "Today's duties:
- Check status of robots on computer terminal in Offices.
- Activate robot workers in Housing Unit.
- Gear up in Ready Room."

A scientist arrives from Catwalk.

* * *

>e
Offices
You pass through Offices, with Catwalk to the north and Operations to the east.

You can see a computer terminal (closed) here.

Your mobile phone buzzes.

>n
Catwalk
Your shoes clomp along the metal surface between the railings leading west to Ready Room and east to Garage.

You can see a scientist here.

Your mobile phone buzzes.

A scientist heads to Garage.

>w
Ready Room
Your gear is stored in the lockers. Housing Units to west, Catwalk east.

You can see some lockers (closed) here.

Your mobile phone buzzes.

>open lockers
You open the lockers, revealing a thick outdoor gear and an EMP Grenade.

Your mobile phone buzzes.

>take al
You can't see any such thing.

>take all
lockers: Taken.
thick outdoor gear: Taken.
EMP Grenade: Taken.

Your mobile phone buzzes.

* * *

>open lockers
You open the lockers, revealing a thick outdoor gear and an EMP Grenade.

Your mobile phone buzzes.

>read phone
Text message: "Today's duties:
- Check status of robots on computer terminal in Offices.
- Activate robot workers in Housing Unit.
- Gear up in Ready Room."

>look
Ready Room
Your gear is stored in the lockers. Housing Units to west, Catwalk east.

You can see some lockers (in which are Thick outdoor gear and EMP Grenade) here.

* * *

>w
Ready Room
Your gear is stored in the lockers. Housing Units to west, Catwalk east.

You can see some lockers (closed) here.

Your mobile phone buzzes.

>open cabinets
You open the cabinets, revealing Thick outdoor gear.

Your mobile phone buzzes.

* * *

>e
Offices
You pass through Offices, with Catwalk to the north and Operations to the east.

You can see a computer terminal (closed) here.

Your mobile phone buzzes.

>read phone
Text message: "Today's duties:
- Check status of robots on computer terminal in Offices.
- Activate robot workers in Housing Unit.
- Gear up in Ready Room."

A scientist arrives from Operations.

>n
Catwalk
Your shoes clank along the metal surface between the railings leading west to Ready Room and east to Garage.

>w
Ready Room
You can see a scientist here.

A scientist heads to Catwalk.

>w
Housing Unit
You can see Humanoid 1, Humanoid 2 and Humanoid 4 here.

>look at Humanoid 1
The eyes look dead.

>Look at Humanoid 2
The face is smashed.

>look at Humandoi 3
You can't see any such thing.

>look at Humanoid 3
You can't see any such thing.

>look at Humanoid 4
The antennae are bent.

A scientist arrives from Ready Room.

>turn on Humanoid 1
The humanoid twitches for a second, but collapses after blowing a fuse.

>turn on Humanoid 2
The humanoid doesn't even respond.

A scientist heads to Ready Room.

>turn on Humanoid 4
The head spins around three times before the eyes roll back and the unit shuts down.

>turn on Humanoid 4
The head spins around three times before the eyes roll back and the unit shuts down.

* * *

>read phone
Text message: "Today's duties:
- Check status of robots on computer terminal in Offices.
- Activate robot workers in Housing Unit.
- Gear up in Ready Room."

A scientist arrives from Operations.

>test duties
(Testing.)

>[1] look at mobile
Text message: "Today's duties:
- Check status of robots on computer terminal in Offices.
- Activate robot workers in Housing Unit.
- Gear up in Ready Room."

>[2] unlock terminal with keycard
You unlock the computer terminal.

A scientist heads to Catwalk.

>[3] open terminal
You open the computer terminal, revealing ROBOTS file.

>[4] read robots.
Robot Locations
Humanoid 1 Housing Unit
Humanoid 2 Housing Unit
Humanoid 3 UNKNOWN
Humanoid 4 Housing Unit

A scientist arrives from Catwalk.

>n
Catwalk
Your shoes jingle along the metal surface between the railings leading west to Ready Room and east to Garage.

>w
Ready Room
Your gear is stored in the lockers. Housing Unit to west, Catwalk east.

You can see some lockers (closed) here.

>open lockers
You open the lockers, revealing a thick outdoor gear and an EMP Grenade.

>take all
thick outdoor gear: Taken.
EMP Grenade: Taken.

>w
Housing Unit
You can see Humanoid 1, Humanoid 2 and Humanoid 4 here.

>e
Ready Room
Your gear is stored in the lockers. Housing Unit to west, Catwalk east.

You can see some lockers (empty) here.

Your mobile phone buzzes.

>read phone
Text message: "Urgent! Suit up in Ready Room. Track down rogue Humanoid 3 outside via Garage."

>e
Catwalk
Your shoes clank along the metal surface between the railings leading west to Ready Room and east to Garage.

>e
Garage
The SnowCat lies dormant in the Garage. Outside to north.

You can see a scientist, some empty fuel canisters and SnowCat (empty) here.

>x Snowcat
A rugged, tracked vehicle with enclosed cab for navigating the treacherous climate outside.

A scientist heads to Catwalk.

>x canisters
You see nothing special about the empty fuel canisters.

>enter Snowcat
You get into SnowCat.

A scientist arrives from Catwalk.

>look
Garage (in SnowCat)
The SnowCat lies dormant in the Garage. Outside to north.

You can see a scientist and some empty fuel canisters here.

* * *

>e
Offices
You pass through Offices, with Catwalk to the north and Operations to the east.

You can see a computer terminal (closed) here.

Your mobile phone buzzes.

>s
You can't go that way.

Your mobile phone buzzes.

A scientist arrives from Operations.

>e
Operations
The clicks and beeps of the supercomputer here match the blinking lights and gauges. West to Offices.

You can see a supercomputer here.

Your mobile phone buzzes.

>take supercomputer
Taken.

Your mobile phone buzzes.

* * *

>take bart
I don't suppose Bart the Bartender would care for that.

Bart the Bartender tends to the beer taps.

>take bar
That's hardly portable.

Bart the Bartender scrubs the stovetop.

>e
Offices
You pass through Offices, with Catwalk to the north and Operations to the east.

You can see a scientist and a computer terminal (closed) here.

Your mobile phone buzzes.

>e
Operations
The clicks and beeps of the supercomputer here match the blinking lights and gauges. West to Offices.

You can see a supercomputer here.

Your mobile phone buzzes.

>take supercomputer
That's fixed in place.

Your mobile phone buzzes.

>take gauges
That seems to be a part of the supercomputer.

Your mobile phone buzzes.

>read phone
Text message: "Alert! A Humanoid worker is missing. Investigate Housing Unit."

>w
Offices
You pass through Offices, with Catwalk to the north and Operations to the east.

You can see a scientist and a computer terminal (closed) here.

A scientist heads to Operations.

>n
Catwalk
Your shoes bang along the metal surface between the railings leading west to Ready Room and east to Garage.

>w
Ready Room
Your gear is stored in the lockers. Housing Units to west, Catwalk east.

You can see some lockers (closed) here.

>open lockers
You open the lockers, revealing a thick outdoor gear and an EMP Grenade.

* * *

>take all
thick outdoor gear: Taken.
EMP Grenade: Taken.

>i
You are carrying:
  an EMP Grenade
  a thick outdoor gear
  a mobile phone
  a keycard
  some grey fatigues (being worn)
  a copy of Research Robotics

>wear gear
You put on the thick outdoor gear.

>i
You are carrying:
  an EMP Grenade
  a thick outdoor gear (being worn)
  a mobile phone
  a keycard
  some grey fatigues (being worn)
  a copy of Research Robotics

>w
Housing Unit
You can see Humanoid 1, Humanoid 2 and Humanoid 4 here.

>examine all
You can't use multiple objects with that verb.

>examine Humanoid 1
The eyes look dead.

>examine Humanoid 2
The face is smashed.

>x Humanoid 4
The antennae are bent.

>turn on Humanoid 1
The humanoid twitches for a second, but collapses after blowing a fuse.

>e
Ready Room
Your gear is stored in the lockers. Housing Units to west, Catwalk east.

You can see some lockers (empty) here.

Your mobile phone buzzes.

>read phone
Text message: "Urgent! Suit up in Ready Room. Track down rogue Humanoid 3 outside via Garage."

* * *

>e
Catwalk
Your shoes clank along the metal surface between the railings leading west to Ready Room and east to Garage.

>e
Garage
You can see SnowCat (empty) here.

* * *

You awaken.

Antarctic Ruse
An Interactive Fiction by Robert Dionne
Release 1 / Serial number 140406 / Inform 7 build 6G60 (I6/v6.32 lib 6/12N) SD

Sleeping Quarters (on your bunk bed)
You are in your bunk bed in Sleeping Quarters. The smell of warm breakfast wafts through the northern hatch. Your alarm clock buzzes loudly.

On the other bunks are some sleeping crew.

On your night stand are an alarm clock, a keycard and a mobile phone.

On your bunk bed you can see a copy of Research Robotics and some grey fatigues.

>test all
(Testing.)

>[1] test awaken
(Testing.)

>[2] take all
copy of Research Robotics: Taken.
grey fatigues: Taken.
keycard: Taken.
mobile phone: Taken.

[Your score has just gone up by two points.]

>[3] put on clothes
You put on the grey fatigues.

>[4] turn off alarm
You switch the alarm clock off.

>[5] north.
(first getting off your bunk bed)
(first opening the hatch)

Mess Hall
The Mess Hall is more properly a bar repurposed at mealtimes for eating, and west of Offices.

On the bar are prepared plates, pint glasses and some beer taps.

You can also see Bart the Bartender here.

Bart the Bartender washes the pint glasses.

>[6] test breakfast
(Testing.)

>[7] take plate
You take a plate from the bar.

Bart the Bartender tends to the beer taps.

>[8] take glass
You take a pint glass from the bar.

Bart the Bartender cleans the beer taps.

>[9] eat pancake
(first taking the pancake)
You eat the pancake. Not bad.

Bart the Bartender prepares the stovetop.

>[10] eat egg
(first taking the egg)
You eat the egg. Not bad.

Bart the Bartender scrubs the beer taps.

A scientist arrives from Offices.

>[11] eat bacon
(first taking the slice of bacon)
You eat the slice of bacon. Not bad.

Bart the Bartender cleans the stovetop.

>[12] eat toast
(first taking the slice of toast)
You eat the slice of toast. Not bad.

Bart the Bartender tends to the prepared plates.

A scientist heads to Offices.

>[13] drink orange juice
You drink the orange juice. Refreshing.

Bart the Bartender washes the prepared plates.

>[14] drop plate and glass
prepared plate: Dropped.
pint glass: Dropped.

Bart the Bartender scrubs the pint glasses.

>[15] turn off bart
You switch Bart the Bartender off.

>[16] east.

Offices
You pass through Offices, with Catwalk to the north and Operations to the east.

You can see a computer terminal (closed) here.

Your mobile phone buzzes.

>[17] test duties.
(Testing.)

>[18] look at mobile
Text message: "Today's duties:
- Check status of robots on computer terminal in Offices.
- Activate robot workers in Housing Unit.
- Gear up in Ready Room."

>[19] unlock terminal with keycard
You unlock the computer terminal.

>[20] open terminal
You open the computer terminal, revealing ROBOTS file.

>[21] read robots.
Robot Locations
Humanoid 1 Housing Unit
Humanoid 2 Housing Unit
Humanoid 3 UNKNOWN
Humanoid 4 Housing Unit

>e
Operations
The clicks and beeps of the supercomputer here match the blinking lights and gauges. West to Offices.

You can see a supercomputer here.

Your mobile phone buzzes.

* * *

>read phone
Text message: "Alert! A Humanoid worker is missing. Investigate Housing Unit."

>e
You can't go that way.

>w
Offices
You pass through Offices, with Catwalk to the north and Operations to the east.

You can see a computer terminal (in which is ROBOTS file) here.

>w
Mess Hall
The Mess Hall is more properly a bar repurposed at mealtimes for eating, and west of Offices.

On the bar are prepared plates, pint glasses and some beer taps.

You can also see a pint glass (empty), a prepared plate (empty) and Bart the Bartender here.

>e
Offices
You pass through Offices, with Catwalk to the north and Operations to the east.

You can see a computer terminal (in which is ROBOTS file) here.

>e
Operations
The clicks and beeps of the supercomputer here match the blinking lights and gauges. West to Offices.

You can see a supercomputer here.

>read gagues
You can't see any such thing.

>read gauges
The gauges report outside temperature -6 degrees celsius.

>w
Offices
You pass through Offices, with Catwalk to the north and Operations to the east.

You can see a computer terminal (in which is ROBOTS file) here.

>n
Catwalk
Your shoes clank along the metal surface between the railings leading west to Ready Room and east to Garage.

>w
Ready Room

>w
Housing Unit
You can see Humanoid 1, Humanoid 2 and Humanoid 4 here.

>turn on Humanoid 1
The humanoid twitches for a second, but collapses after blowing a fuse.

>e
Ready Room
Your mobile phone buzzes.

>read phone
Text message: "Urgent! Suit up in Ready Room. Track down rogue Humanoid 3 outside via Garage."

* * *

>w
Offices
You pass through Offices, with Catwalk to the north and Operations to the east.

You can see a computer terminal (in which is ROBOTS file) here.

>n
Catwalk
Your shoes clomp along the metal surface between the railings leading west to Ready Room and east to Garage.

You can see a scientist here.

A scientist heads to Garage.

>e
Garage
The SnowCat lies dormant in the Garage. Outside to north.

You can see a scientist, some empty fuel canisters and SnowCat (empty) here.

You can't feel your toes.

>n
Grid 0-1
A scientist arrives from Garage.

Brrrrrrr.

>n
You can't go that way.

You can't feel your toes.

>w
Grid 0-0
You are getting cold.

>e
Grid 0-1
Brrrrrrr.

    *** You have died of hypothermia. ***

In that game you scored 2 out of a possible 0, in 27 turns.

Would you like to RESTART, RESTORE a saved game, QUIT or UNDO the last command?

* * *

>read phone
Text message: "Alert! A Humanoid worker is missing. Investigate Housing Unit."

>read gauges
The gauges report -91 degrees celsius.

>w
Offices
You pass through Offices, with Catwalk to the north and Operations to the east.

You can see a computer terminal (in which is ROBOTS file) here.

A scientist arrives from Operations.

* * *

>w
Mess Hall
The Mess Hall is more properly a bar repurposed at mealtimes for eating, and west of Offices.

On the bar are prepared plates, pint glasses and some beer taps.

You can also see a pint glass (empty), a prepared plate (empty) and Bart the Bartender here.

>e
Offices
You pass through Offices, with Catwalk to the north and Operations to the east.

You can see a scientist and a computer terminal (in which is ROBOTS file) here.

A scientist heads to Catwalk.

>n
Catwalk
Your shoes clank along the metal surface between the railings leading west to Ready Room and east to Garage.

You can see a scientist here.

>e
Garage
You can see SnowCat (empty) here.

A scientist arrives from Catwalk.

>enter snowcat
You get into SnowCat.

>n
Grid 0-1 (in SnowCat)

>n
You can't go that way.

>w
Grid 0-0 (in SnowCat)

>n
Grid 1-0 (in SnowCat)

>n
You can't go that way.

>e
Grid 1-1 (in SnowCat)

>n
Grid 2-1 (in SnowCat)

>n
You can't go that way.

>w
Grid 2-0 (in SnowCat)

>n
Grid 3-0 (in SnowCat)

>e
Grid 3-1 (in SnowCat)

>e
Grid 3-2 (in SnowCat)

>e
You cannot drive SnowCat to Ice Crevasse.

>exit
You get out of SnowCat.

Grid 3-2
You can see SnowCat (empty) here.

* * *

>n
Catwalk
Your shoes clomp along the metal surface between the railings leading west to Ready Room and east to Garage.

>w
Ready Room
Your gear is stored in the lockers. Housing Unit to west, Catwalk east.

You can see some lockers (closed) here.

* * *

>open lockers
You open the lockers, revealing a thick outdoor gear and an EMP Grenade.

>take all
thick outdoor gear: Taken.
EMP Grenade: Taken.

A scientist arrives from Catwalk.

>wear gear
You put on the thick outdoor gear.

>e
Catwalk
Your shoes clank along the metal surface between the railings leading west to Ready Room and east to Garage.

>e
Garage
The SnowCat lies dormant in the Garage. Outside to north.

You can see some empty fuel canisters and SnowCat (empty) here.

>n
Grid 0-1

>w
Grid 0-0

>e
Grid 0-1

>e
Grid 0-2

>e
Off the Grid
You are off the known grid and wandering the icy plains.

Brrrrrrr.

>e
Off the Grid
You are off the known grid and wandering the frigid plains.

It's kinda cold out here.

>e
Off the Grid
You are off the known grid and wandering the icy plains.

You can't feel your toes.

>n
Off the Grid
You are off the known grid and wandering the frigid plains.

Brrrrrrr.

>s
Off the Grid
You are off the known grid and wandering the glacial plains.

You can't feel your toes.

    *** You have died of hypothermia. ***

In that game you scored 2 out of a possible 0, in 34 turns.

Would you like to RESTART, RESTORE a saved game, QUIT or UNDO the last command?

* * *

>e
Catwalk
Your shoes clank along the metal surface between the railings leading west to Ready Room and east to Garage.

>s
Offices
You pass through Offices, with Catwalk to the north and Operations to the east.

You can see a computer terminal (in which is ROBOTS file) here.

>e
Operations
The clicks and beeps of the supercomputer here match the blinking lights and gauges. West to Offices.

You can see a supercomputer here.

Your mobile phone buzzes.

>turn off supercomputer
Your mobile phone buzzes.

It's kinda cold out here.

>e
You can't go that way.

Your mobile phone buzzes.

Brrrrrrr.

* * *

>n
Catwalk
Your shoes clomp along the metal surface between the railings leading west to Ready Room and east to Garage.

>n
You can't go that way.

>w
Ready Room
Your gear is stored in the lockers. Housing Unit to west, Catwalk east.

You can see some lockers (closed) here.

* * *

>take all
thick outdoor gear: Taken.
EMP Grenade: Taken.

>wear gear
You put on the thick outdoor gear.

>ee
That's not a verb I recognize.

>e
Catwalk
Your shoes clank along the metal surface between the railings leading west to Ready Room and east to Garage.

* * *

>w
Grid 0-0

>n
Grid 1-0

>n
You can't go that way.

>e
Grid 1-1

>n
Grid 2-1

>w
Grid 2-0

>n
Grid 3-0

>n
Ice Cave
You can see Humanoid 3 here.

>s
Grid 3-0

>e
Grid 3-1

>w
Grid 3-0

>w
Ice Cavern

>e
Grid 3-0

>e
Grid 3-1

>e
Grid 3-2

>e
Ice Crevasse

>w
Grid 3-2

>w
Grid 3-1

>w
Grid 3-0

>e
Grid 3-1

>n
Off the Grid
You are off the known grid and wandering the frozen plains.

You can see a scientist here.

A scientist heads to Off the Grid.
A scientist arrives from Off the Grid.

You can't feel your toes.

>look at scientist
You see nothing special about the scientist.

You are getting cold.