You awaken.

Antarctic Ruse
An Interactive Fiction by Robert Dionne
Release 1 / Serial number 140405 / Inform 7 build 6G60 (I6/v6.32 lib 6/12N) SD

Sleeping Quarters (on your bunk bed)
You are in your bunk bed in Sleeping Quarters. The smell of warm breakfast wafts through the northern hatch. Your alarm clock buzzes loudly.

On the other bunks are some sleeping crew.

On your night stand are an alarm clock, a keycard and a mobile phone.

You can also see ROBOTS file here.

On your bunk bed you can see a copy of Research Robotics and some grey fatigues.

>take all
copy of Research Robotics: Taken.
grey fatigues: Taken.
keycard: mobile phone: [Your score has just gone up by two points.]

>put on clothes
You put on the grey fatigues.

>n
A dozing crew member whispers abruptly, "Could you shut that thing off!"

>turn off alarm
You switch the alarm clock off.

>n
(first getting off your bunk bed)

Mess Hall
The Mess Hall is more properly a bar repurposed at mealtimes for eating. East to Offices.

On the bar are prepared plates, pint glasses and some beer taps.

You can also see Bart the Bartender and a scientist here.

Bart the Bartender tends to the pint glasses.

>e
Offices
Offices

You can see a computer here.

>look at computer
You see nothing special about the computer.

* * *

>e
Offices
Offices

You can see a computer here.

>look
Offices
Offices

You can see a scientist and a monitor here.

* * *

>put on clothes
You put on the grey fatigues.

>turn off alarm
You switch the alarm clock off.

>n
(first getting off your bunk bed)

Mess Hall
The Mess Hall is more properly a bar repurposed at mealtimes for eating. East to Offices.

On the bar are prepared plates, pint glasses and some beer taps.

You can also see Bart the Bartender here.

Bart the Bartender tends to the beer taps.

A scientist arrives from Offices.

>e
Offices
Offices

You can see a computer (in which is ROBOTS file) here.

>take file
That's fixed in place.

A scientist arrives from Mess Hall.

>read ROBOTS
Robots in Housing Unit
Humanoid 1 yes
Humanoid 2 yes
Humanoid 3 yes
Humanoid 4 yes

>move Humanoid 3 to Offices
You can't see any such thing.

>purloin Humanoid 3
[Purloined.]

>look
Offices
Offices

You can see a scientist and a computer (in which is ROBOTS file) here.

A scientist heads to Mess Hall.

>read ROBOTS
Robots in Housing Unit
Humanoid 1 yes
Humanoid 2 yes
Humanoid 3 NO
Humanoid 4 yes

>i
You are carrying:
  Humanoid 3
  a mobile phone
  a keycard
  some grey fatigues (being worn)
  a copy of Research Robotics

A scientist arrives from Mess Hall.

>drop Humanoid 3
Dropped.

>i
You are carrying:
  a mobile phone
  a keycard
  some grey fatigues (being worn)
  a copy of Research Robotics

A scientist heads to Catwalk.

>look
Offices
Offices

You can see Humanoid 3 and a computer (in which is ROBOTS file) here.

* * *

>e
Offices
Offices

You can see a computer (in which is ROBOTS file) here.

>take INVENTORY
You are carrying:
  a mobile phone
  a keycard
  some grey fatigues (being worn)
  a copy of Research Robotics

A scientist heads to Catwalk.

* * *

>i
You are carrying:
  a mobile phone
    ROBOTS
  a keycard
  some grey fatigues (being worn)
  a copy of Research Robotics

>read ROBOTS
Humanoids 0-13.

* * *

>e
Offices
Offices

You can see a computer (in which is ROBOTS file) here.

>look
Offices
Offices

WARNING** Humanoid 13C not present in housing unit.

You can also see a scientist here.

A scientist heads to Mess Hall.

* * *

>e
Offices
Offices

You can see a computer (in which is ROBOTS file) here.

>read ROBOTS
Robots in Housing Unit
Humanoid 1 YES
Humanoid 2 YES
Humanoid 3 NO
Humanoid 4 YES

A scientist arrives from Mess Hall.

* * *

>n
(first getting off your bunk bed)

Mess Hall
The Mess Hall is more properly a bar repurposed at mealtimes for eating. East to Offices.

On the bar are prepared plates, pint glasses and some beer taps.

You can also see Bart the Bartender here.

Bart the Bartender tends to the beer taps.

A scientist arrives from Offices.

>look
Mess Hall
The Mess Hall is more properly a bar repurposed at mealtimes for eating. East to Offices.

On the bar are prepared plates, pint glasses and some beer taps.

You can also see Bart the Bartender and a scientist here.

Bart the Bartender tends to the beer taps.

>look
Mess Hall
The Mess Hall is more properly a bar repurposed at mealtimes for eating. East to Offices.

On the bar are prepared plates, pint glasses and some beer taps.

You can also see Bart the Bartender and a scientist here.

Bart the Bartender tends to the beer taps.

>look
Mess Hall
The Mess Hall is more properly a bar repurposed at mealtimes for eating. East to Offices.

On the bar are prepared plates, pint glasses and some beer taps.

You can also see Bart the Bartender and a scientist here.

Bart the Bartender tends to the stovetop.

>look
Mess Hall
The Mess Hall is more properly a bar repurposed at mealtimes for eating. East to Offices.

On the bar are prepared plates, pint glasses and some beer taps.

You can also see Bart the Bartender and a scientist here.

Bart the Bartender tends to the stovetop.

>look
Mess Hall
The Mess Hall is more properly a bar repurposed at mealtimes for eating. East to Offices.

On the bar are prepared plates, pint glasses and some beer taps.

You can also see Bart the Bartender and a scientist here.

Bart the Bartender tends to the pint glasses.

>look
Mess Hall
The Mess Hall is more properly a bar repurposed at mealtimes for eating. East to Offices.

On the bar are prepared plates, pint glasses and some beer taps.

You can also see Bart the Bartender and a scientist here.

Bart the Bartender tends to the prepared plates.

>look
Mess Hall
The Mess Hall is more properly a bar repurposed at mealtimes for eating. East to Offices.

On the bar are prepared plates, pint glasses and some beer taps.

You can also see Bart the Bartender here.

Bart the Bartender tends to the pint glasses.

>look
Mess Hall
The Mess Hall is more properly a bar repurposed at mealtimes for eating. East to Offices.

On the bar are prepared plates, pint glasses and some beer taps.

You can also see Bart the Bartender here.

Bart the Bartender tends to the stovetop.

>look
Mess Hall
The Mess Hall is more properly a bar repurposed at mealtimes for eating. East to Offices.

On the bar are prepared plates, pint glasses and some beer taps.

You can also see Bart the Bartender here.

Bart the Bartender tends to the prepared plates.

>look
Mess Hall
The Mess Hall is more properly a bar repurposed at mealtimes for eating. East to Offices.

On the bar are prepared plates, pint glasses and some beer taps.

You can also see Bart the Bartender here.

Bart the Bartender tends to the stovetop.

>look
Mess Hall
The Mess Hall is more properly a bar repurposed at mealtimes for eating. East to Offices.

On the bar are prepared plates, pint glasses and some beer taps.

You can also see Bart the Bartender here.

Bart the Bartender tends to the pint glasses.

>look
Mess Hall
The Mess Hall is more properly a bar repurposed at mealtimes for eating. East to Offices.

On the bar are prepared plates, pint glasses and some beer taps.

You can also see Bart the Bartender here.

Bart the Bartender tends to the beer taps.

>look
Mess Hall
The Mess Hall is more properly a bar repurposed at mealtimes for eating. East to Offices.

On the bar are prepared plates, pint glasses and some beer taps.

You can also see Bart the Bartender here.

Bart the Bartender tends to the stovetop.

>look
Mess Hall
The Mess Hall is more properly a bar repurposed at mealtimes for eating. East to Offices.

On the bar are prepared plates, pint glasses and some beer taps.

You can also see Bart the Bartender here.

Bart the Bartender tends to the stovetop.

>look
Mess Hall
The Mess Hall is more properly a bar repurposed at mealtimes for eating. East to Offices.

On the bar are prepared plates, pint glasses and some beer taps.

You can also see Bart the Bartender here.

Bart the Bartender tends to the beer taps.

>look
Mess Hall
The Mess Hall is more properly a bar repurposed at mealtimes for eating. East to Offices.

On the bar are prepared plates, pint glasses and some beer taps.

You can also see Bart the Bartender here.

Bart the Bartender tends to the beer taps.

* * *

>look
Mess Hall
The Mess Hall is more properly a bar repurposed at mealtimes for eating. East to Offices.

On the bar are prepared plates, pint glasses and some beer taps.

You can also see Bart the Bartender here.

Bart the Bartender tends to the pint glasses.

>look
Mess Hall
The Mess Hall is more properly a bar repurposed at mealtimes for eating. East to Offices.

On the bar are prepared plates, pint glasses and some beer taps.

You can also see Bart the Bartender here.

Bart the Bartender tends to the prepared plates.

>look
Mess Hall
The Mess Hall is more properly a bar repurposed at mealtimes for eating. East to Offices.

On the bar are prepared plates, pint glasses and some beer taps.

You can also see Bart the Bartender here.

Bart the Bartender tends to the beer taps.

>look
Mess Hall
The Mess Hall is more properly a bar repurposed at mealtimes for eating. East to Offices.

On the bar are prepared plates, pint glasses and some beer taps.

You can also see Bart the Bartender here.

Bart the Bartender tends to the prepared plates.

>look
Mess Hall
The Mess Hall is more properly a bar repurposed at mealtimes for eating. East to Offices.

On the bar are prepared plates, pint glasses and some beer taps.

You can also see Bart the Bartender here.

Bart the Bartender tends to the prepared plates.

>look
Mess Hall
The Mess Hall is more properly a bar repurposed at mealtimes for eating. East to Offices.

On the bar are prepared plates, pint glasses and some beer taps.

You can also see a scientist and Bart the Bartender here.

Bart the Bartender tends to the beer taps.

>look
Mess Hall
The Mess Hall is more properly a bar repurposed at mealtimes for eating. East to Offices.

On the bar are prepared plates, pint glasses and some beer taps.

You can also see a scientist and Bart the Bartender here.

Bart the Bartender tends to the prepared plates.

>look
Mess Hall
The Mess Hall is more properly a bar repurposed at mealtimes for eating. East to Offices.

On the bar are prepared plates, pint glasses and some beer taps.

You can also see a scientist and Bart the Bartender here.

Bart the Bartender tends to the beer taps.

>look
Mess Hall
The Mess Hall is more properly a bar repurposed at mealtimes for eating. East to Offices.

On the bar are prepared plates, pint glasses and some beer taps.

You can also see a scientist and Bart the Bartender here.

Bart the Bartender tends to the beer taps.

>look
Mess Hall
The Mess Hall is more properly a bar repurposed at mealtimes for eating. East to Offices.

On the bar are prepared plates, pint glasses and some beer taps.

You can also see Bart the Bartender here.

Bart the Bartender tends to the prepared plates.

* * *

>look
Mess Hall
The Mess Hall is more properly a bar repurposed at mealtimes for eating. East to Offices.

On the bar are prepared plates, pint glasses and some beer taps.

You can also see Bart the Bartender here.

Bart the Bartender tends to the beer taps.

>look
Mess Hall
The Mess Hall is more properly a bar repurposed at mealtimes for eating. East to Offices.

On the bar are prepared plates, pint glasses and some beer taps.

You can also see Bart the Bartender here.

Bart the Bartender tends to the pint glasses.

* * *

>look
Mess Hall
The Mess Hall is more properly a bar repurposed at mealtimes for eating. East to Offices.

On the bar are prepared plates, pint glasses and some beer taps.

You can also see Bart the Bartender here.

Bart the Bartender tends to the beer taps.

>look
Mess Hall
The Mess Hall is more properly a bar repurposed at mealtimes for eating. East to Offices.

On the bar are prepared plates, pint glasses and some beer taps.

You can also see a scientist and Bart the Bartender here.

Bart the Bartender tends to the prepared plates.

>look
Mess Hall
The Mess Hall is more properly a bar repurposed at mealtimes for eating. East to Offices.

On the bar are prepared plates, pint glasses and some beer taps.

You can also see a scientist and Bart the Bartender here.

Bart the Bartender tends to the prepared plates.

* * *

>take all
copy of Research Robotics: Taken.
grey fatigues: Taken.
keycard: mobile phone: [Your score has just gone up by two points.]

>put on fatigues
You put on the grey fatigues.

>turn off alarm
You switch the alarm clock off.

>n
(first getting off your bunk bed)

Mess Hall
The Mess Hall is more properly a bar repurposed at mealtimes for eating. East to Offices.

On the bar are prepared plates, pint glasses and some beer taps.

You can also see Bart the Bartender and a scientist here.

Bart the Bartender tends to the prepared plates.

>s
Best not to disturb those that are sleeping.

Bart the Bartender tends to the beer taps.

>e
Offices
Offices

You can see a computer (in which is ROBOTS file) here.

A scientist arrives from Mess Hall.

>read ROBOTS
Robots in Housing Unit
Humanoid 1 yes
Humanoid 2 yes
Humanoid 3 NO
Humanoid 4 yes

* * *

>take all
copy of Research Robotics: Taken.
grey fatigues: Taken.
keycard: mobile phone: [Your score has just gone up by two points.]

>n
You should probably get dressed first!

>put on clothes
You put on the grey fatigues.

* * *

>turn off alarm
You switch the alarm clock off.

>n
(first getting off your bunk bed)

Mess Hall
The Mess Hall is more properly a bar repurposed at mealtimes for eating. East to Offices.

On the bar are prepared plates, pint glasses and some beer taps.

You can also see Bart the Bartender and a scientist here.

Bart the Bartender tends to the beer taps.

>e
Offices
Offices

You can see a computer (in which is ROBOTS file) here.

>take ROBOTS
Taken.

>look
Offices
Offices

You can see a computer (empty) here.

>i
You are carrying:
  ROBOTS file
  a mobile phone
  a keycard
  some grey fatigues (being worn)
  a copy of Research Robotics

>put ROBOTS file in computer
You put ROBOTS file into the computer.

A scientist arrives from Mess Hall.

>look
Offices
Offices

You can see a scientist and a computer (in which is ROBOTS file) here.

* * *

>turn off alarm
You switch the alarm clock off.

>get dressed
You can't see any such thing.

>put on clothes
You put on the grey fatigues.

>n
(first getting off your bunk bed)

Mess Hall
The Mess Hall is more properly a bar repurposed at mealtimes for eating. East to Offices.

On the bar are prepared plates, pint glasses and some beer taps.

You can also see Bart the Bartender here.

Bart the Bartender tends to the prepared plates.

A scientist arrives from Offices.

>e
Offices
Offices

You can see a monitor here.

* * *

You awaken.

Antarctic Ruse
An Interactive Fiction by Robert Dionne
Release 1 / Serial number 140405 / Inform 7 build 6G60 (I6/v6.32 lib 6/12N) SD

Sleeping Quarters (on your bunk bed)
You are in your bunk bed in Sleeping Quarters. The smell of warm breakfast wafts through the northern hatch. Your alarm clock buzzes loudly.

On the other bunks are some sleeping crew.

On your night stand are an alarm clock, a keycard and a mobile phone.

You can also see ROBOTS file here.

On your bunk bed you can see a copy of Research Robotics and some grey fatigues.

>read ROBOST
You can't see any such thing.

* * *

You awaken.

Antarctic Ruse
An Interactive Fiction by Robert Dionne
Release 1 / Serial number 140405 / Inform 7 build 6G60 (I6/v6.32 lib 6/12N) SD

Sleeping Quarters (on your bunk bed)
You are in your bunk bed in Sleeping Quarters. The smell of warm breakfast wafts through the northern hatch. Your alarm clock buzzes loudly.

On the other bunks are some sleeping crew.

On your night stand are an alarm clock, a keycard and a mobile phone.

You can also see ROBOTS file here.

On your bunk bed you can see a copy of Research Robotics and some grey fatigues.

>look
Sleeping Quarters (on your bunk bed)
You are in your bunk bed in Sleeping Quarters. The smell of warm breakfast wafts through the northern hatch. Your alarm clock buzzes loudly.

On the other bunks are some sleeping crew.

On your night stand are an alarm clock, a keycard and a mobile phone.

You can also see ROBOTS file here.

On your bunk bed you can see a copy of Research Robotics and some grey fatigues.

>take all
copy of Research Robotics: Taken.
grey fatigues: Taken.
keycard: mobile phone: [Your score has just gone up by two points.]

* * *

>turn off alarm
You switch the alarm clock off.

>n
(first getting off your bunk bed)

Mess Hall
The Mess Hall is more properly a bar repurposed at mealtimes for eating. East to Offices.

On the bar are prepared plates, pint glasses and some beer taps.

You can also see Bart the Bartender here.

Bart the Bartender tends to the beer taps.

>e
Offices
Offices

You can see a scientist and a computer (in which is ROBOTS file) here.

A scientist heads to Operations.

>open computer
That's not something you can open.

>look
Offices
Offices

You can see a computer (in which is ROBOTS file) here.

A scientist arrives from Operations.

* * *

>i
You are carrying:
  a mobile phone
    ROBOTS file
  a keycard
  some grey fatigues (being worn)
  a copy of Research Robotics

A scientist heads to Catwalk.

>read ROBOTS file
Humanoids 0-13.

>put ROBOTS file in computer
(first taking ROBOTS file)

A scientist arrives from Catwalk.

>look
Offices
Offices

You can see a scientist and a computer (empty) here.

>i
You are carrying:
  a mobile phone
    ROBOTS file
  a keycard
  some grey fatigues (being worn)
  a copy of Research Robotics

A scientist heads to Mess Hall.

* * *

>look
Sleeping Quarters (on your bunk bed)
You are in your bunk bed in Sleeping Quarters. The smell of warm breakfast wafts through the northern hatch. Your alarm clock buzzes loudly.

On the other bunks are some sleeping crew.

On your night stand are an alarm clock, a keycard and a mobile phone.

You can also see ROBOTS file here.

On your bunk bed you can see a copy of Research Robotics and some grey fatigues.

>n
You should probably get dressed first!

>take all
copy of Research Robotics: Taken.
grey fatigues: Taken.
keycard: mobile phone: [Your score has just gone up by two points.]

* * *

>put on clothes
You put on the grey fatigues.

>turno ff alarm
That's not a verb I recognize.

>turn off alarm
You switch the alarm clock off.

>n
(first getting off your bunk bed)

Mess Hall
The Mess Hall is more properly a bar repurposed at mealtimes for eating. East to Offices.

On the bar are prepared plates, pint glasses and some beer taps.

You can also see Bart the Bartender here.

Bart the Bartender tends to the stovetop.

>e
Offices
Offices

You can see a computer (in which is ROBOTS file) here.

>read ROBOTS file
Humanoids 0-13.

A scientist arrives from Catwalk.

>look
Offices
Offices

You can see a scientist and a computer (in which is ROBOTS file) here.

>read ROBOTS
Humanoids 0-13.

A scientist heads to Operations.

>read ROBOTS
Humanoids 0-13.

* * *

>look
Sleeping Quarters (on your bunk bed)
You are in your bunk bed in Sleeping Quarters. The smell of warm breakfast wafts through the northern hatch. Your alarm clock buzzes loudly.

On the other bunks are some sleeping crew.

On your night stand are an alarm clock, a keycard and a mobile phone.

You can also see ROBOTS file here.

On your bunk bed you can see a copy of Research Robotics and some grey fatigues.

>read ROBOTS
Robot Locations
Humanoid 1 Housing Unit
Humanoid 2 yes
Humanoid 3 NO
Humanoid 4 yes

* * *

You awaken.

Antarctic Ruse
An Interactive Fiction by Robert Dionne
Release 1 / Serial number 140405 / Inform 7 build 6G60 (I6/v6.32 lib 6/12N) SD

Sleeping Quarters (on your bunk bed)
You are in your bunk bed in Sleeping Quarters. The smell of warm breakfast wafts through the northern hatch. Your alarm clock buzzes loudly.

On the other bunks are some sleeping crew.

On your night stand are an alarm clock, a keycard and a mobile phone.

You can also see ROBOTS file here.

On your bunk bed you can see a copy of Research Robotics and some grey fatigues.

>takea ll
That's not a verb I recognize.

* * *

You awaken.

Antarctic Ruse
An Interactive Fiction by Robert Dionne
Release 1 / Serial number 140405 / Inform 7 build 6G60 (I6/v6.32 lib 6/12N) SD

Sleeping Quarters (on your bunk bed)
You are in your bunk bed in Sleeping Quarters. The smell of warm breakfast wafts through the northern hatch. Your alarm clock buzzes loudly.

On the other bunks are some sleeping crew.

On your night stand are an alarm clock, a keycard and a mobile phone.

You can also see ROBOTS file here.

On your bunk bed you can see a copy of Research Robotics and some grey fatigues.

>test me
>--> No test scripts exist for this game.