You awaken.

Antarctic Ruse
An Interactive Fiction by Robert Dionne
Release 1 / Serial number 140406 / Inform 7 build 6G60 (I6/v6.32 lib 6/12N) SD

Sleeping Quarters (on your bunk bed)
You are in your bunk bed in Sleeping Quarters. The smell of warm breakfast wafts through the northern hatch. Your alarm clock buzzes loudly.

On the other bunks are some sleeping crew.

On your night stand are an alarm clock, a keycard and a mobile phone.

On your bunk bed you can see a copy of Research Robotics and some grey fatigues.

>test awaken
(Testing.)

>[1] take all
copy of Research Robotics: Taken.
grey fatigues: Taken.
keycard: Taken.
mobile phone: Taken.

[Your score has just gone up by two points.]

>[2] put on clothes
You put on the grey fatigues.

>[3] turn off alarm
You switch the alarm clock off.

>[4] north.
(first getting off your bunk bed)
(first opening the hatch)

Mess Hall
The Mess Hall is more properly a bar repurposed at mealtimes for eating, and west of Offices.

On the bar are prepared plates, pint glasses and some beer taps.

You can also see Bart the Bartender here.

Bart the Bartender prepares the prepared plates.

A scientist arrives from Offices.

>e
Offices
You pass through Offices, with Catwalk to the north and Operations to the east.

You can see a computer terminal (closed) here.

Your mobile phone buzzes.

>n
Catwalk
Your shoes clomp along the metal surface between the railings leading west to Ready Room and east to Garage.

Your mobile phone buzzes.

>e
Garage
You can see SnowCat (empty) here.

Your mobile phone buzzes.

>n
Grid 0-1
Your mobile phone buzzes.

>n
You can't go that way.

Your mobile phone buzzes.

>e
Grid 0-2
Your mobile phone buzzes.

>e
Off the Grid
You are off the known grid and wandering the glacial plains.

Your mobile phone buzzes.

You can't feel your toes.

>undo
Grid 0-2
[Previous turn undone.]

>n
Grid 1-2
Your mobile phone buzzes.

>n
Grid 2-2
Your mobile phone buzzes.

>e
Off the Grid
You are off the known grid and wandering the frigid plains.

Your mobile phone buzzes.

It's kinda cold out here.

>undo
Grid 2-2
[Previous turn undone.]

* * *

You awaken.

Antarctic Ruse
An Interactive Fiction by Robert Dionne
Release 1 / Serial number 140406 / Inform 7 build 6G60 (I6/v6.32 lib 6/12N) SD

Sleeping Quarters (on your bunk bed)
You are in your bunk bed in Sleeping Quarters. The smell of warm breakfast wafts through the northern hatch. Your alarm clock buzzes loudly.

On the other bunks are some sleeping crew.

On your night stand are an alarm clock, a keycard and a mobile phone.

On your bunk bed you can see a copy of Research Robotics and some grey fatigues.

>test all
(Testing.)

>[1] test awaken
(Testing.)

>[2] take all
copy of Research Robotics: Taken.
grey fatigues: Taken.
keycard: Taken.
mobile phone: Taken.

[Your score has just gone up by two points.]

>[3] put on clothes
You put on the grey fatigues.

>[4] turn off alarm
You switch the alarm clock off.

>[5] north.
(first getting off your bunk bed)
(first opening the hatch)

Mess Hall
The Mess Hall is more properly a bar repurposed at mealtimes for eating, and west of Offices.

On the bar are prepared plates, pint glasses and some beer taps.

You can also see Bart the Bartender here.

Bart the Bartender prepares the pint glasses.

>[6] test breakfast
(Testing.)

>[7] take plate
You take a plate from the bar.

Bart the Bartender cleans the prepared plates.

>[8] take glass
You take a pint glass from the bar.

Bart the Bartender tends to the prepared plates.

>[9] eat pancake
(first taking the pancake)
You eat the pancake. Not bad.

Bart the Bartender prepares the stovetop.

>[10] eat egg
(first taking the egg)
You eat the egg. Not bad.

Bart the Bartender scrubs the prepared plates.

>[11] eat bacon
(first taking the slice of bacon)
You eat the slice of bacon. Not bad.

Bart the Bartender tends to the prepared plates.

>[12] eat toast
(first taking the slice of toast)
You eat the slice of toast. Not bad.

Bart the Bartender cleans the beer taps.

>[13] drink orange juice
You drink the orange juice. Refreshing.

Bart the Bartender tends to the beer taps.

>[14] drop plate and glass
prepared plate: Dropped.
pint glass: Dropped.

Bart the Bartender cleans the beer taps.

>[15] turn off bart
You switch Bart the Bartender off.

>[16] east.

Offices
You pass through Offices, with Catwalk to the north and Operations to the east.

You can see a computer terminal (closed) here.

Your mobile phone buzzes.

A scientist arrives from Catwalk.

>[17] test duties.
(Testing.)

>[18] look at mobile
Text message: "Today's duties:
- Check status of robots on computer terminal in Offices.
- Activate robot workers in Housing Unit.
- Gear up in Ready Room."

>[19] unlock terminal with keycard
You unlock the computer terminal.

A scientist heads to Mess Hall.

>[20] open terminal
You open the computer terminal, revealing ROBOTS file.

>[21] read robots.
Robot Locations
Humanoid 1 Housing Unit
Humanoid 2 Housing Unit
Humanoid 3 UNKNOWN
Humanoid 4 Housing Unit

A scientist arrives from Mess Hall.

>e
Operations
The clicks and beeps of the supercomputer here match the blinking lights and gauges. West to Offices.

You can see a supercomputer here.

Your mobile phone buzzes.

>read phone
Text message: "Alert! A Humanoid worker is missing. Investigate Housing Unit."

A scientist arrives from Offices.

>turn off computer
You can't see any such thing.

>turn off supercomputer
You can't feel your toes.

It is now pitch dark in here!

>w
Darkness
It is pitch dark, and you can't see a thing.

You are getting cold.

>n
Darkness
It is pitch dark, and you can't see a thing.

You can't feel your toes.

>w
Darkness
It is pitch dark, and you can't see a thing.

Brrrrrrr.

>n
You can't go that way.

It's kinda cold out here.

    *** You have died of hypothermia. ***

In that game you scored 2 out of a possible 0, in 25 turns.

Would you like to RESTART, RESTORE a saved game, QUIT or UNDO the last command?

* * *

>e
Operations
The clicks and beeps of the supercomputer here match the blinking lights and gauges. West to Offices.

You can see a supercomputer here.

Your mobile phone buzzes.

>look at mobile phone
Text message: "Alert! A Humanoid worker is missing. Head to Housing Unit."

A scientist arrives from Offices.

>w
Offices
You pass through Offices, with Catwalk to the north and Operations to the east.

You can see a computer terminal (in which is ROBOTS file) here.

>n
Catwalk

* * *

>e
Operations
The clicks and beeps of the supercomputer here match the blinking lights and gauges. West to Offices.

You can see a supercomputer here.

Your mobile phone buzzes.

>look at supercomputer
This machine guides all the research here at Antarctic #57.

Your mobile phone buzzes.

* * *

>e
Operations
The clicks and beeps of the supercomputer here match the blinking lights and gauges. West to Offices.

You can see a supercomputer here.

Your mobile phone buzzes.

>look at mobile
Text message: "Alert! A Humanoid worker is missing. Head to Housing Unit."

>w
Offices
You pass through Offices, with Catwalk to the north and Operations to the east.

You can see a computer terminal (in which is ROBOTS file) here.

>n
Catwalk
Your shoes bang along the metal surface between the railings leading west to Ready Room and east to Garage.

You can see a scientist here.

A scientist heads to Ready Room.

>w
Ready Room
You can see a scientist here.

>w
Housing Unit
You can see Humanoid 1, Humanoid 2 and Humanoid 4 here.

>turn on Humanoid 1
You switch Humanoid 1 on.

* * *

>e
Operations
The clicks and beeps of the supercomputer here match the blinking lights and gauges. West to Offices.

You can see a supercomputer here.

Your mobile phone buzzes.

>examine supercomputer
This machine guides all the research here at Antarctic #57.

>examine blinking lights
They flicker faster than you can see.

>read gauges
The gauges report -91 degrees celcius.

>read gauges
The gauges report -20 degrees celcius.

* * *

>e
Operations
The clicks and beeps of the supercomputer here match the blinking lights and gauges. West to Offices.

You can see a supercomputer here.

Your mobile phone buzzes.

>check mobile phone
Text message: "Alert! A Humanoid worker is missing. Head to Housing Unit."

>w
Offices
You pass through Offices, with Catwalk to the north and Operations to the east.

You can see a computer terminal (in which is ROBOTS file) here.

* * *

>e
Operations
The clicks and beeps of the supercomputer here match the blinking lights and gauges. West to Offices.

You can see a supercomputer here.

Your mobile phone buzzes.

>turn off computer
Your mobile phone buzzes.

Brrrrrrr.

>e
You can't go that way.

Your mobile phone buzzes.

Brrrrrrr.

>w
Darkness
It is pitch dark, and you can't see a thing.

Your mobile phone buzzes.

It's kinda cold out here.

>read phone
It is pitch dark, and you can't see a thing.

Your mobile phone buzzes.

You can't feel your toes.

>read phone
It is pitch dark, and you can't see a thing.

Your mobile phone buzzes.

You are getting cold.

    *** You have died of hypothermia. ***

In that game you scored 2 out of a possible 0, in 24 turns.

Would you like to RESTART, RESTORE a saved game, QUIT or UNDO the last command?

* * *

>turn off computer
Your mobile phone buzzes.

Brrrrrrr.

>w
Offices
You pass through Offices, with Catwalk to the north and Operations to the east.

You can see a computer terminal (in which is ROBOTS file) here.

Your mobile phone buzzes.

It's kinda cold out here.

>read phone
Text message: "Alert! A Humanoid worker is missing. Investigate Housing Unit."

You can't feel your toes.

It is now pitch dark in here!

>look
Darkness
It is pitch dark, and you can't see a thing.

It's kinda cold out here.

>n
Darkness
It is pitch dark, and you can't see a thing.

You are getting cold.

    *** You have died of hypothermia. ***

In that game you scored 2 out of a possible 0, in 24 turns.

Would you like to RESTART, RESTORE a saved game, QUIT or UNDO the last command?

* * *

>e
Operations
The clicks and beeps of the supercomputer here match the blinking lights and gauges. West to Offices.

You can see a supercomputer here.

Your mobile phone buzzes.

>turn off supercomputer
Your mobile phone buzzes.

You can't feel your toes.

>read mobile phone
Text message: "Alert! A Humanoid worker is missing. Investigate Housing Unit."

You are getting cold.

>e
You can't go that way.

It's kinda cold out here.

>w
Offices
You pass through Offices, with Catwalk to the north and Operations to the east.

You can see a computer terminal (in which is ROBOTS file) here.

You are getting cold.

>e
Operations
West to Offices.

You can see a supercomputer here.

Brrrrrrr.

    *** You have died of hypothermia. ***

In that game you scored 2 out of a possible 0, in 24 turns.

Would you like to RESTART, RESTORE a saved game, QUIT or UNDO the last command?

* * *

>turn off supercomputer
Your mobile phone buzzes.

You can't feel your toes.

>turn on supercomputer
You can't see any such thing.

>look
Darkness
It is pitch dark, and you can't see a thing.

Your mobile phone buzzes.

You are getting cold.

>read phone
It is pitch dark, and you can't see a thing.

Your mobile phone buzzes.

Brrrrrrr.

>read mobile phone
It is pitch dark, and you can't see a thing.

Your mobile phone buzzes.

You are getting cold.

* * *

>e
Operations
The clicks and beeps of the supercomputer here match the blinking lights and gauges. West to Offices.

You can see a supercomputer here.

Your mobile phone buzzes.

>switch off supercomputer
You switch the supercomputer off.

Your mobile phone buzzes.

>look at supercomputer
This machine guides all the research here at Antarctic #57.

The supercomputer is currently switched off.

Your mobile phone buzzes.

* * *

>w
Mess Hall
The Mess Hall is more properly a bar repurposed at mealtimes for eating, and west of Offices.

On the bar are prepared plates, pint glasses and some beer taps.

You can also see a pint glass (empty), a prepared plate (empty) and Bart the Bartender here.

* * *

>exit
You get out of SnowCat.

Grid 3-2
You can see SnowCat (empty) here.

>e
Ice Crevasse

* * *

You awaken.

Antarctic Ruse
An Interactive Fiction by Robert Dionne
Release 1 / Serial number 140406 / Inform 7 build 6G60 (I6/v6.32 lib 6/12N) SD

Sleeping Quarters (on your bunk bed)
You are in your bunk bed in Sleeping Quarters. The smell of warm breakfast wafts through the northern hatch. Your alarm clock buzzes loudly.

On the other bunks are some sleeping crew.

On your night stand are an alarm clock, a keycard and a mobile phone.

On your bunk bed you can see a copy of Research Robotics and some grey fatigues.

>test breakfast
(Testing.)

>[1] take plate
You can't see any such thing.

>[2] take glass
You can't see any such thing.

>[3] eat pancake
You can't see any such thing.

>[4] eat egg
You can't see any such thing.

>[5] eat bacon
You can't see any such thing.

>[6] eat toast
You can't see any such thing.

>[7] drink orange juice
You can't see any such thing.

>[8] drop plate and glass
You can't see any such thing.

>[9] turn off bart
You can't see any such thing.

>[10] east.
(first getting off your bunk bed)
You can't go that way.

>test all
(Testing.)

>[1] test awaken
(Testing.)

>[2] take all
copy of Research Robotics: Taken.
grey fatigues: Taken.
keycard: Taken.
mobile phone: Taken.

[Your score has just gone up by two points.]

>[3] put on clothes
You put on the grey fatigues.

>[4] turn off alarm
You switch the alarm clock off.

>[5] north.
(first opening the hatch)

Mess Hall
The Mess Hall is more properly a bar repurposed at mealtimes for eating, and west of Offices.

On the bar are prepared plates, pint glasses and some beer taps.

You can also see Bart the Bartender here.

Bart the Bartender cleans the pint glasses.

>[6] test breakfast
(Testing.)

>[7] take plate
You take a plate from the bar.

Bart the Bartender tends to the pint glasses.

>[8] take glass
You take a pint glass from the bar.

Bart the Bartender scrubs the prepared plates.

>[9] eat pancake
(first taking the pancake)
You eat the pancake. Not bad.

Bart the Bartender tends to the pint glasses.

>[10] eat egg
(first taking the egg)
You eat the egg. Not bad.

Bart the Bartender prepares the prepared plates.

>[11] eat bacon
(first taking the slice of bacon)
You eat the slice of bacon. Not bad.

Bart the Bartender washes the beer taps.

>[12] eat toast
(first taking the slice of toast)
You eat the slice of toast. Not bad.

Bart the Bartender tends to the stovetop.

>[13] drink orange juice
You drink the orange juice. Refreshing.

Bart the Bartender prepares the beer taps.

>[14] drop plate and glass
prepared plate: Dropped.
pint glass: Dropped.

Bart the Bartender cleans the pint glasses.

>[15] turn off bart
You switch Bart the Bartender off.

>[16] east.

Offices
You pass through Offices, with Catwalk to the north and Operations to the east.

You can see a computer terminal (closed) here.

Your mobile phone buzzes.

>[17] test duties.
(Testing.)

>[18] look at mobile
Text message: "Today's duties:
- Check status of robots on computer terminal in Offices.
- Activate robot workers in Housing Unit.
- Gear up in Garage."

>[19] unlock terminal with keycard
You unlock the computer terminal.

>[20] open terminal
You open the computer terminal, revealing ROBOTS file.

>[21] read robots.
Robot Locations
Humanoid 1 Housing Unit
Humanoid 2 Housing Unit
Humanoid 3 UNKNOWN
Humanoid 4 Housing Unit

>look
Offices
You pass through Offices, with Catwalk to the north and Operations to the east.

You can see a computer terminal (in which is ROBOTS file) here.

* * *

You awaken.

Antarctic Ruse
An Interactive Fiction by Robert Dionne
Release 1 / Serial number 140406 / Inform 7 build 6G60 (I6/v6.32 lib 6/12N) SD

Sleeping Quarters (on your bunk bed)
You are in your bunk bed in Sleeping Quarters. The smell of warm breakfast wafts through the northern hatch. Your alarm clock buzzes loudly.

On the other bunks are some sleeping crew.

On your night stand are an alarm clock, a keycard and a mobile phone.

On your bunk bed you can see a copy of Research Robotics and some grey fatigues.

>look
Sleeping Quarters (on your bunk bed)
You are in your bunk bed in Sleeping Quarters. The smell of warm breakfast wafts through the northern hatch. Your alarm clock buzzes loudly.

On the other bunks are some sleeping crew.

On your night stand are an alarm clock, a keycard and a mobile phone.

On your bunk bed you can see a copy of Research Robotics and some grey fatigues.

>test all
(Testing.)

>[1] test awaken
(Testing.)

>[2] take all
copy of Research Robotics: Taken.
grey fatigues: Taken.
keycard: Taken.
mobile phone: Taken.

[Your score has just gone up by two points.]

>[3] put on clothes
You put on the grey fatigues.

>[4] turn off alarm
You switch the alarm clock off.

>[5] north.
(first getting off your bunk bed)
(first opening the hatch)

Mess Hall
The Mess Hall is more properly a bar repurposed at mealtimes for eating, and west of Offices.

On the bar are prepared plates, pint glasses and some beer taps.

You can also see Bart the Bartender here.

Bart the Bartender prepares the pint glasses.

>[6] test breakfast
(Testing.)

>[7] take plate
You take a plate from the bar.

Bart the Bartender tends to the prepared plates.

>[8] take glass
You take a pint glass from the bar.

Bart the Bartender washes the pint glasses.

>[9] eat pancake
(first taking the pancake)
You eat the pancake. Not bad.

Bart the Bartender cleans the beer taps.

>[10] eat egg
(first taking the egg)
You eat the egg. Not bad.

Bart the Bartender tends to the prepared plates.

>[11] eat bacon
(first taking the slice of bacon)
You eat the slice of bacon. Not bad.

Bart the Bartender washes the prepared plates.

>[12] eat toast
(first taking the slice of toast)
You eat the slice of toast. Not bad.

Bart the Bartender scrubs the prepared plates.

>[13] drink orange juice
You drink the orange juice. Refreshing.

Bart the Bartender washes the stovetop.

>[14] drop plate and glass
prepared plate: Dropped.
pint glass: Dropped.

Bart the Bartender prepares the prepared plates.

>[15] turn off bart
You switch Bart the Bartender off.

>[16] east.

Offices
You pass through Offices, with Catwalk to the north and Operations to the east.

You can see a computer terminal (closed) here.

Your mobile phone buzzes.

>[17] test duties.
(Testing.)

>[18] look at mobile
Text message: "Today's duties:
- Check status of robots on computer terminal in Offices.
- Activate robot workers in Housing Unit.
- Gear up in Ready Room."

>[19] unlock terminal with keycard
You unlock the computer terminal.

>[20] open terminal
You open the computer terminal, revealing ROBOTS file.

>[21] read robots.
Robot Locations
Humanoid 1 Housing Unit
Humanoid 2 Housing Unit
Humanoid 3 UNKNOWN
Humanoid 4 Housing Unit

>n
Catwalk
Your shoes clomp along the metal surface between the railings leading west to Ready Room and east to Garage.

>e
Garage
You can see SnowCat (empty) here.

* * *

>n
Grid 0-1

>n
You can't go that way.

>n
You can't go that way.

>e
Grid 0-2

>n
Grid 1-2

>n
Grid 2-2

>w
Grid 2-1

>n
Grid 3-1

>n
You can't go that way.

>w
Grid 3-0

* * *

>e
Grid 3-2

>e
You can't go that way.

>s
Grid 2-2

>e
Off the Grid
You are off the known grid and wandering the icy plains.

You can see a scientist here.

A scientist heads to Off the Grid.
A scientist arrives from Off the Grid.

It's kinda cold out here.

>e
Off the Grid
You are off the known grid and wandering the glacial plains.

You can see a scientist here.

You are getting cold.

>e
Off the Grid
You are off the known grid and wandering the frozen plains.

You can see a scientist here.

A scientist heads to Off the Grid.
A scientist arrives from Off the Grid.

Brrrrrrr.

>s
Off the Grid
You are off the known grid and wandering the icy plains.

You can see a scientist here.

You can't feel your toes.

>e
Off the Grid
You are off the known grid and wandering the glacial plains.

You can see a scientist here.

A scientist heads to Off the Grid.
A scientist arrives from Off the Grid.

You are getting cold.

    *** You have died of hypothermia. ***

In that game you scored 2 out of a possible 0, in 40 turns.

Would you like to RESTART, RESTORE a saved game, QUIT or UNDO the last command?