You awaken.

Antarctic Ruse
An Interactive Fiction by Robert Dionne
Release 1 / Serial number 140406 / Inform 7 build 6G60 (I6/v6.32 lib 6/12N) SD

Sleeping Quarters (on your bunk bed)
You are in your bunk bed in Sleeping Quarters. The smell of warm breakfast wafts through the northern hatch. Your alarm clock buzzes loudly.

On the other bunks are some sleeping crew.

On your night stand are an alarm clock, a keycard and a mobile phone.

On your bunk bed you can see a copy of Research Robotics and some grey fatigues.

>and the player is in the SnowCat
That's not a verb I recognize.

>take all then get dressed then turn off alarm then go north
copy of Research Robotics: Taken.
grey fatigues: Taken.
keycard: mobile phone: [Your score has just gone up by two points.]

You can't see any such thing.

>take all then put on clothes then turn off alarm then go north
There are none at all available!

>put on clothes then turn off alarm then go north
You put on the grey fatigues.

You switch the alarm clock off.

(first getting off your bunk bed)
(first opening the hatch)
Mess Hall
The Mess Hall is more properly a bar repurposed at mealtimes for eating. East leads to Offices.

On the bar are prepared plates, pint glasses and some beer taps.

You can also see Bart the Bartender here.

Bart the Bartender tends to the pint glasses.

>e
Offices
Offices

You can see a computer terminal (closed) here.

>n
Catwalk
You can see a scientist here.

A scientist heads to Garage.

>e
Garage
You can see a scientist and SnowCat (empty) here.

>enter SnowCat
You get into SnowCat.

A scientist heads to Grid 0-1.

>n
Grid 0-1 (in SnowCat)
You can see a scientist here.

>e
Grid 0-2 (in SnowCat)

>e
Off the Grid (in SnowCat)
You won't be able to drive much farther.

>n
Off the Grid (in SnowCat)
The fuel is low.

A scientist arrives from Grid 0-0.

>e
Off the Grid (in SnowCat)
You can see a scientist here.

Running out of gas.

>e
Off the Grid (in SnowCat)
You can see a scientist here.

You won't be able to drive much farther.

A scientist heads to Off the Grid.
A scientist arrives from Off the Grid.

>e
Off the Grid (in SnowCat)
You can see a scientist here.

Running out of gas.

SnowCat is out of fuel!

Off the Grid
You can see SnowCat (empty) and a scientist here.

>n
Off the Grid
You can see SnowCat (empty) and a scientist here.

A scientist heads to Off the Grid.
A scientist arrives from Off the Grid.

>e
Off the Grid
You can see a scientist and SnowCat (empty) here.

>n
Off the Grid
You can see a scientist and SnowCat (empty) here.

A scientist heads to Off the Grid.
A scientist arrives from Off the Grid.

>e
Off the Grid
You can see a scientist and SnowCat (empty) here.

>e
Off the Grid
You can see a scientist and SnowCat (empty) here.

A scientist heads to Off the Grid.
A scientist arrives from Off the Grid.

>n
Off the Grid
You can see a scientist and SnowCat (empty) here.

>e
Off the Grid
You can see a scientist and SnowCat (empty) here.

A scientist heads to Off the Grid.
A scientist arrives from Off the Grid.

>e
Off the Grid
You can see a scientist and SnowCat (empty) here.

* * *

You awaken.

Antarctic Ruse
An Interactive Fiction by Robert Dionne
Release 1 / Serial number 140406 / Inform 7 build 6G60 (I6/v6.32 lib 6/12N) SD

Sleeping Quarters (on your bunk bed)
You are in your bunk bed in Sleeping Quarters. The smell of warm breakfast wafts through the northern hatch. Your alarm clock buzzes loudly.

On the other bunks are some sleeping crew.

On your night stand are an alarm clock, a keycard and a mobile phone.

On your bunk bed you can see a copy of Research Robotics and some grey fatigues.

>read ROBOST
You can't see any such thing.

>read ROBOTS
Robot Locations
Humanoid 1 Housing Unit
Humanoid 2 Housing Unit
Humanoid 3 Ice Cave
Humanoid 4 Housing Unit

* * *

You awaken.

Antarctic Ruse
An Interactive Fiction by Robert Dionne
Release 1 / Serial number 140406 / Inform 7 build 6G60 (I6/v6.32 lib 6/12N) SD

Sleeping Quarters (on your bunk bed)
You are in your bunk bed in Sleeping Quarters. The smell of warm breakfast wafts through the northern hatch. Your alarm clock buzzes loudly.

On the other bunks are some sleeping crew.

On your night stand are an alarm clock, a keycard and a mobile phone.

On your bunk bed you can see a copy of Research Robotics and some grey fatigues.

>take all then put on clothes then turn off alarm then go north
copy of Research Robotics: Taken.
grey fatigues: Taken.
keycard: mobile phone: [Your score has just gone up by two points.]

You put on the grey fatigues.

You switch the alarm clock off.

(first getting off your bunk bed)
(first opening the hatch)
Mess Hall
The Mess Hall is more properly a bar repurposed at mealtimes for eating. East leads to Offices.

On the bar are prepared plates, pint glasses and some beer taps.

You can also see Bart the Bartender here.

Bart the Bartender tends to the beer taps.

>n
You can't go that way.

Bart the Bartender tends to the prepared plates.

>e
Offices
Offices

You can see a computer terminal (closed) here.

A scientist arrives from Catwalk.

>n
Catwalk

>e
Garage
You can see SnowCat (empty) here.

>enter SnowCat
You get into SnowCat.

>n
Grid 0-1 (in SnowCat)

>e
Grid 0-2 (in SnowCat)

>e
Off the Grid (in SnowCat)
Running out of gas.

>n
Off the Grid (in SnowCat)
Brrrrrrr.

>w
Off the Grid (in SnowCat)
It's kinda cold out here.

>s
Off the Grid (in SnowCat)
Brrrrrrr.

>e
Off the Grid (in SnowCat)
You can't feel your toes.

    *** You have died of hypothermia. ***

In that game you scored 2 out of a possible 0, in 16 turns.

Would you like to RESTART, RESTORE a saved game, QUIT or UNDO the last command?

* * *

>e
Off the Grid (in SnowCat)
Running out of gas.

>e
Off the Grid (in SnowCat)
You won't be able to drive much farther.

>n
Off the Grid (in SnowCat)
Running out of gas.

>w
Off the Grid (in SnowCat)
The gas meter is getting lower.

>e
Off the Grid (in SnowCat)
You won't be able to drive much farther.

SnowCat is out of fuel!

Off the Grid
You can see SnowCat (empty) here.

>enter SnowCat
You get into SnowCat.

The gas meter is getting lower.

>e
Off the Grid (in SnowCat)
Running out of gas.

>exit SnowCat
I only understood you as far as wanting to exit.

* * *

>e
Garage
You can see SnowCat (empty) here.

>enter snowcat
You get into SnowCat.

* * *

>e
Off the Grid (in SnowCat)
Running out of gas.

>e
Off the Grid (in SnowCat)
The fuel is low.

>e
Off the Grid (in SnowCat)
Running out of gas.

>e
Off the Grid (in SnowCat)
The fuel is low.

Brrrrrrr.

>e
Off the Grid (in SnowCat)
You won't be able to drive much farther.

It's kinda cold out here.

SnowCat is out of fuel!

    *** You have died of hypothermia. ***

In that game you scored 2 out of a possible 0, in 16 turns.

Would you like to RESTART, RESTORE a saved game, QUIT or UNDO the last command?

>n
Please give one of the answers above.

Would you like to RESTART, RESTORE a saved game, QUIT or UNDO the last command?

* * *

>e
Off the Grid (in SnowCat)
Running out of gas.

I beg your pardon?

>e
Off the Grid (in SnowCat)
You won't be able to drive much farther.

>n
Off the Grid (in SnowCat)
The fuel is low.

SnowCat is out of fuel!

>e
SnowCat is out of fuel!

>exit
You get out of SnowCat.

Off the Grid
You can see SnowCat (empty) here.

Brrrrrrr.

>e
Off the Grid
You can see SnowCat (empty) here.

You can't feel your toes.

>n
Off the Grid
You can see SnowCat (empty) here.

You are getting cold.

>e
Off the Grid
You can see SnowCat (empty) here.

Brrrrrrr.

>s
Off the Grid
You can see SnowCat (empty) here.

You are getting cold.

    *** You have died of hypothermia. ***

In that game you scored 2 out of a possible 0, in 22 turns.

Would you like to RESTART, RESTORE a saved game, QUIT or UNDO the last command?

* * *

>take all then put on clothes then turn off alarm then go north
copy of Research Robotics: Taken.
grey fatigues: Taken.
keycard: mobile phone: [Your score has just gone up by two points.]

You put on the grey fatigues.

You switch the alarm clock off.

(first getting off your bunk bed)
(first opening the hatch)
Mess Hall
The Mess Hall is more properly a bar repurposed at mealtimes for eating. East leads to Offices.

On the bar are prepared plates, pint glasses and some beer taps.

You can also see Bart the Bartender here.

Bart the Bartender tends to the beer taps.

>e
Offices
Offices

You can see a computer terminal (closed) here.

>n
Catwalk

* * *

>e
Grid 0-2 (in SnowCat)

>e
Off the Grid (in SnowCat)
You are off the known grid and wandering the frozen plains.

Running out of gas.

>n
Off the Grid (in SnowCat)
You are off the known grid and wandering the frigid plains.

You won't be able to drive much farther.

>e
Off the Grid (in SnowCat)
You are off the known grid and wandering the icy plains.

Running out of gas.

>n
Off the Grid (in SnowCat)
You are off the known grid and wandering the glacial plains.

You won't be able to drive much farther.

>s
Off the Grid (in SnowCat)
You are off the known grid and wandering the frigid plains.

Running out of gas.

SnowCat is out of fuel!

>e
SnowCat is out of fuel!

>exit
You get out of SnowCat.

Off the Grid
You are off the known grid and wandering the glacial plains.

You can see SnowCat (empty) here.

Brrrrrrr.

>n
Off the Grid
You are off the known grid and wandering the icy plains.

You can see SnowCat (empty) here.

It's kinda cold out here.

>e
Off the Grid
You are off the known grid and wandering the frozen plains.

You can see SnowCat (empty) here.

You are getting cold.

>e
Off the Grid
You are off the known grid and wandering the frigid plains.

You can see SnowCat (empty) here.

You can't feel your toes.

>s
Off the Grid
You are off the known grid and wandering the frozen plains.

You can see SnowCat (empty) here.

It's kinda cold out here.

    *** You have died of hypothermia. ***

In that game you scored 2 out of a possible 0, in 21 turns.

Would you like to RESTART, RESTORE a saved game, QUIT or UNDO the last command?

* * *

>e
Off the Grid (in SnowCat)
You are off the known grid and wandering the frozen plains.

Running out of gas.

I beg your pardon?

>e
Off the Grid (in SnowCat)
The gas meter is getting lower.

>e
Off the Grid (in SnowCat)
The fuel is low.

>e
Off the Grid (in SnowCat)
The gas meter is getting lower.

>n
Off the Grid (in SnowCat)
You won't be able to drive much farther.

SnowCat is out of fuel!

>e
SnowCat is out of fuel!

* * *

>exit
You get out of SnowCat.

Off the Grid
You can see SnowCat (empty) here.

Brrrrrrr.

>enter
You get into SnowCat.

You can't feel your toes.

>e
SnowCat is out of fuel!

You are getting cold.

>n
SnowCat is out of fuel!

It's kinda cold out here.

>e
SnowCat is out of fuel!

Brrrrrrr.

    *** You have died of hypothermia. ***

In that game you scored 2 out of a possible 0, in 21 turns.

Would you like to RESTART, RESTORE a saved game, QUIT or UNDO the last command?

* * *

>e
Garage
You can see SnowCat (empty) here.

>enter Snowcat
You get into SnowCat.

>n
Grid 0-1 (in SnowCat)

* * *

>e
Grid 0-2 (in SnowCat)

>e
Off the Grid (in SnowCat)
The gas meter is getting lower.

>e
Off the Grid (in SnowCat)
You won't be able to drive much farther.

>e
Off the Grid (in SnowCat)
The fuel is low.

* * *

>e
Off the Grid (in SnowCat)
Running out of gas.

>e
Off the Grid (in SnowCat)
The gas meter is getting lower.

SnowCat is out of fuel!

>get out
You get out of SnowCat.

Off the Grid
You can see SnowCat (empty) here.

>n
Off the Grid
You can see SnowCat (empty) here.

>e
Off the Grid
You can see SnowCat (empty) here.

>e
Off the Grid
You can see SnowCat (empty) here.

>en
That's not a verb I recognize.

>e
Off the Grid
You can see SnowCat (empty) here.

>n
Off the Grid
You can see SnowCat (empty) here.

* * *

>e
Garage
You can see SnowCat (empty) here.

>get in SnowCat
You get into SnowCat.

>n
Grid 0-1 (in SnowCat)

* * *

>e
Off the Grid (in SnowCat)
You won't be able to drive much farther.

>n
Off the Grid (in SnowCat)
The fuel is low.

>e
Off the Grid (in SnowCat)
The gas meter is getting lower.

>s
Off the Grid (in SnowCat)
You won't be able to drive much farther.

>e
Off the Grid (in SnowCat)
Running out of gas.

SnowCat is out of fuel!

>look
Off the Grid (in SnowCat)
You won't be able to drive much farther.

* * *

>e
Off the Grid (in SnowCat)
You won't be able to drive much farther.

>e
Off the Grid (in SnowCat)
Running out of gas.

>n
Off the Grid (in SnowCat)
The fuel is low.

>e
Off the Grid (in SnowCat)
You won't be able to drive much farther.

* * *

>e
SnowCat is out of fuel!

>n
SnowCat is out of fuel!

>exit
You get out of SnowCat.

Off the Grid
You can see SnowCat (empty) here.

>n
Off the Grid
You can see SnowCat (empty) here.

* * *

>e
Off the Grid
You can see SnowCat (empty) here.

>look
Off the Grid
You can see SnowCat (empty) here.

>n
Off the Grid
You can see SnowCat (empty) here.

* * *

>e
Off the Grid (in SnowCat)
You won't be able to drive much farther.

>e
Off the Grid (in SnowCat)
You won't be able to drive much farther.

>e
Off the Grid (in SnowCat)
The gas meter is getting lower.

I beg your pardon?

>e
Off the Grid (in SnowCat)
Running out of gas.

>s
Off the Grid (in SnowCat)
The fuel is low.

Off the Grid
You can see SnowCat (empty) here.

* * *

>n
Off the Grid (in SnowCat)
Running out of gas.

>e
Off the Grid (in SnowCat)
The fuel is low.

>s
Off the Grid (in SnowCat)
You won't be able to drive much farther.

>e
Off the Grid (in SnowCat)
The gas meter is getting lower.

SnowCat is out of fuel!

Off the Grid
You can see SnowCat (empty) here.

>enter SnowCat
SnowCat is out of fuel!

You won't be able to drive much farther.

>look
Off the Grid
You can see SnowCat (empty) here.

Running out of gas.

>e
Off the Grid
You can see SnowCat (empty) here.

The gas meter is getting lower.

* * *

>n
Off the Grid (in SnowCat)
Running out of gas.

>n
Off the Grid (in SnowCat)
The fuel is low.

* * *

>e
Off the Grid (in SnowCat)
The gas meter is getting lower.

>e
Off the Grid (in SnowCat)
Running out of gas.

SnowCat is out of fuel!

>n
SnowCat is out of fuel!

>e
SnowCat is out of fuel!

* * *

>exit
You get out of SnowCat.

Off the Grid
You can see SnowCat (empty) here.

>e
Off the Grid
You can see SnowCat (empty) here.

* * *

>n
Off the Grid
You can see SnowCat (empty) here.

>n
Off the Grid
You can see SnowCat (empty) here.

>en
That's not a verb I recognize.

>en
That's not a verb I recognize.

I beg your pardon?

>n
Off the Grid
You can see SnowCat (empty) here.

* * *

You awaken.

Antarctic Ruse
An Interactive Fiction by Robert Dionne
Release 1 / Serial number 140406 / Inform 7 build 6G60 (I6/v6.32 lib 6/12N) SD

Sleeping Quarters (on your bunk bed)
You are in your bunk bed in Sleeping Quarters. The smell of warm breakfast wafts through the northern hatch. Your alarm clock buzzes loudly.

On the other bunks are some sleeping crew.

On your night stand are an alarm clock, a keycard and a mobile phone.

On your bunk bed you can see a copy of Research Robotics and some grey fatigues.

>Hypothermia occurs in four turns from now;
That's not a verb I recognize.

>Now the player is cold.
That's not a verb I recognize.

* * *

You awaken.

Antarctic Ruse
An Interactive Fiction by Robert Dionne
Release 1 / Serial number 140406 / Inform 7 build 6G60 (I6/v6.32 lib 6/12N) SD

Sleeping Quarters (on your bunk bed)
You are in your bunk bed in Sleeping Quarters. The smell of warm breakfast wafts through the northern hatch. Your alarm clock buzzes loudly.

On the other bunks are some sleeping crew.

On your night stand are an alarm clock, a keycard and a mobile phone.

On your bunk bed you can see a copy of Research Robotics and some grey fatigues.

>takea ll
That's not a verb I recognize.

>take all
copy of Research Robotics: Taken.
grey fatigues: Taken.
keycard: mobile phone: [Your score has just gone up by two points.]

>turn off alarm
You switch the alarm clock off.

>put on clothes
You put on the grey fatigues.

>n
(first getting off your bunk bed)

Mess Hall
The Mess Hall is more properly a bar repurposed at mealtimes for eating. East to Offices.

On the bar are prepared plates, pint glasses and some beer taps.

You can also see Bart the Bartender and a scientist here.

Bart the Bartender tends to the stovetop.

>e
Your mobile phone buzzes: "Get to the operations wing, as soon as possible."

* * *

You awaken.

Antarctic Ruse
An Interactive Fiction by Robert Dionne
Release 1 / Serial number 140406 / Inform 7 build 6G60 (I6/v6.32 lib 6/12N) SD

Sleeping Quarters (on your bunk bed)
You are in your bunk bed in Sleeping Quarters. The smell of warm breakfast wafts through the northern hatch. Your alarm clock buzzes loudly.

On the other bunks are some sleeping crew.

On your night stand are an alarm clock, a keycard and a mobile phone.

On your bunk bed you can see a copy of Research Robotics and some grey fatigues.

>test me
>--> No test scripts exist for this game.