>Instead of going by the SnowCat when the SnowCat is out-of-fuel:
I beg your pardon?

>Say "[The SnowCat] is out of fuel!"
That's not a verb I recognize.

>take all then put on clothes then turn off alarm then go north
copy of Research Robotics: Taken.
grey fatigues: Taken.
keycard: mobile phone: [Your score has just gone up by two points.]

You put on the grey fatigues.

You switch the alarm clock off.

(first getting off your bunk bed)
(first opening the hatch)
Mess Hall
The Mess Hall is more properly a bar repurposed at mealtimes for eating. East leads to Offices.

On the bar are prepared plates, pint glasses and some beer taps.

You can also see Bart the Bartender here.

Bart the Bartender tends to the stovetop.

>e
Offices
Offices

You can see a computer terminal (closed) here.

* * *

>e
Grid 0-2 (in SnowCat)

>e
Off the Grid (in SnowCat)
You are off the known grid and wandering the frigid plains.

The gas meter is getting lower.

>w
Off the Grid (in SnowCat)
You are off the known grid and wandering the glacial plains.

Running out of gas.

>e
Off the Grid (in SnowCat)
You are off the known grid and wandering the frozen plains.

The gas meter is getting lower.

>n
Off the Grid (in SnowCat)
You are off the known grid and wandering the frigid plains.

The fuel is low.

>s
Off the Grid (in SnowCat)
You are off the known grid and wandering the icy plains.

Running out of gas.

SnowCat is out of fuel!

>e
SnowCat is out of fuel!

>exit
You get out of SnowCat.

Off the Grid
You are off the known grid and wandering the frigid plains.

You can see SnowCat (empty) here.

You are getting cold.

>s
Off the Grid
You are off the known grid and wandering the glacial plains.

You can see SnowCat (empty) here.

It's kinda cold out here.

>e
Off the Grid
You are off the known grid and wandering the frozen plains.

You can see SnowCat (empty) here.

You can't feel your toes.

>w
Off the Grid
You are off the known grid and wandering the icy plains.

You can see SnowCat (empty) here.

Brrrrrrr.

>e
Off the Grid
You are off the known grid and wandering the frozen plains.

You can see SnowCat (empty) here.

It's kinda cold out here.

    *** You have died of hypothermia. ***

In that game you scored 2 out of a possible 0, in 21 turns.

Would you like to RESTART, RESTORE a saved game, QUIT or UNDO the last command?

* * *

I beg your pardon?

>test awken
>--> The following tests are available:
'test awaken'
'test breakfast'
'test all'

>test awaken
(Testing.)

>[1] take all
copy of Research Robotics: Taken.
grey fatigues: Taken.
keycard: mobile phone: [Your score has just gone up by two points.]

>[2] put on clothes
You put on the grey fatigues.

>[3] turn off alarm
You switch the alarm clock off.

>[4] north.
(first getting off your bunk bed)
(first opening the hatch)

Mess Hall
The Mess Hall is more properly a bar repurposed at mealtimes for eating. East leads to Offices.

On the bar are prepared plates, pint glasses and some beer taps.

You can also see Bart the Bartender here.

Bart the Bartender tends to the prepared plates.

>test breakfast
(Testing.)

>[1] take plate
You take a plate from the bar.

Bart the Bartender tends to the pint glasses.

>[2] take glass
You take a pint glass from the bar.

Bart the Bartender tends to the pint glasses.

>[3] eat pancake
(first taking the pancake)
You eat the pancake. Not bad.

Bart the Bartender tends to the pint glasses.

>[4] eat egg
(first taking the egg)
You eat the egg. Not bad.

Bart the Bartender tends to the beer taps.

A scientist arrives from Offices.

>[5] eat bacon
(first taking the slice of bacon)
You eat the slice of bacon. Not bad.

Bart the Bartender tends to the beer taps.

>[6] eat toast
(first taking the slice of toast)
You eat the slice of toast. Not bad.

Bart the Bartender tends to the beer taps.

A scientist heads to Offices.

>[7] drink orange juice
You drink the orange juice. Refreshing.

Bart the Bartender tends to the stovetop.

>[8] drop plate and glass
prepared plate: Dropped.
pint glass: Dropped.

Bart the Bartender tends to the pint glasses.

A scientist arrives from Offices.

>[9] turn off bart
You switch Bart the Bartender off.

>[10] east.

Offices
You pass through Offices, with Catwalk to the north and Operations to the east.

You can see a computer terminal (closed) here.

A scientist arrives from Mess Hall.

>open terminal
It seems to be locked.

>unlock terminal
What do you want to unlock the computer terminal with?

>unlock terminal with keycard
You unlock the computer terminal.

A scientist heads to Operations.

>open termianl
You can't see any such thing.

>open terminal
You open the computer terminal, revealing ROBOTS file.

>examine self
As good-looking as ever.

A scientist arrives from Operations.

* * *

I beg your pardon?

>Catwalk is north of Offices.
That's not a verb I recognize.

* * *

You awaken.

Antarctic Ruse
An Interactive Fiction by Robert Dionne
Release 1 / Serial number 140406 / Inform 7 build 6G60 (I6/v6.32 lib 6/12N) SD

Sleeping Quarters (on your bunk bed)
You are in your bunk bed in Sleeping Quarters. The smell of warm breakfast wafts through the northern hatch. Your alarm clock buzzes loudly.

On the other bunks are some sleeping crew.

On your night stand are an alarm clock, a keycard and a mobile phone.

On your bunk bed you can see a copy of Research Robotics and some grey fatigues.

>take all / put on clothes / turn off alarm / go north
You can't see any such thing.

* * *

You awaken.

Antarctic Ruse
An Interactive Fiction by Robert Dionne
Release 1 / Serial number 140406 / Inform 7 build 6G60 (I6/v6.32 lib 6/12N) SD

Sleeping Quarters (on your bunk bed)
You are in your bunk bed in Sleeping Quarters. The smell of warm breakfast wafts through the northern hatch. Your alarm clock buzzes loudly.

On the other bunks are some sleeping crew.

On your night stand are an alarm clock, a keycard and a mobile phone.

On your bunk bed you can see a copy of Research Robotics and some grey fatigues.

>take all then put on clothes then turn off alarm then go north
copy of Research Robotics: Taken.
grey fatigues: Taken.
keycard: mobile phone: [Your score has just gone up by two points.]

You put on the grey fatigues.

You switch the alarm clock off.

(first getting off your bunk bed)
(first opening the hatch)
Mess Hall
The Mess Hall is more properly a bar repurposed at mealtimes for eating. East leads to Offices.

On the bar are prepared plates, pint glasses and some beer taps.

You can also see Bart the Bartender here.

Bart the Bartender tends to the stovetop.

A scientist arrives from Offices.

>n
You can't go that way.

Bart the Bartender tends to the prepared plates.

* * *

>e
Offices
Offices

You can see a computer terminal (closed) here.

* * *

>e
Garage
You can see SnowCat (empty) here.

>n
Grid 0-1

>e
Grid 0-2

>e
Off the Grid
You are off the known grid and wandering the frigid plains.

Brrrrrrr.

>n
Off the Grid
You are off the known grid and wandering the glacial plains.

It's kinda cold out here.

>n
Off the Grid
You are off the known grid and wandering the frigid plains.

You can't feel your toes.

>e
Off the Grid
You are off the known grid and wandering the icy plains.

It's kinda cold out here.

>n
Off the Grid
You are off the known grid and wandering the glacial plains.

You are getting cold.

    *** You have died of hypothermia. ***

In that game you scored 2 out of a possible 0, in 14 turns.

Would you like to RESTART, RESTORE a saved game, QUIT or UNDO the last command?

* * *

You awaken.

Antarctic Ruse
An Interactive Fiction by Robert Dionne
Release 1 / Serial number 140406 / Inform 7 build 6G60 (I6/v6.32 lib 6/12N) SD

Sleeping Quarters (on your bunk bed)
You are in your bunk bed in Sleeping Quarters. The smell of warm breakfast wafts through the northern hatch. Your alarm clock buzzes loudly.

On the other bunks are some sleeping crew.

On your night stand are an alarm clock, a keycard and a mobile phone.

On your bunk bed you can see a copy of Research Robotics and some grey fatigues.

>test
>--> The following tests are available:
'test me'

>test me
(Testing.)

>[1] take all
copy of Research Robotics: Taken.
grey fatigues: Taken.
keycard: mobile phone: [Your score has just gone up by two points.]

>[2] put on clothes
You put on the grey fatigues.

>[3] turn off alarm
You switch the alarm clock off.

>[4] go north
(first getting off your bunk bed)
(first opening the hatch)

Mess Hall
The Mess Hall is more properly a bar repurposed at mealtimes for eating. East leads to Offices.

On the bar are prepared plates, pint glasses and some beer taps.

You can also see Bart the Bartender here.

Bart the Bartender tends to the pint glasses.

A scientist arrives from Offices.

>[5] take plate
You take a plate from the bar.

Bart the Bartender tends to the pint glasses.

>[6] take glass
You take a pint glass from the bar.

Bart the Bartender tends to the stovetop.

A scientist heads to Offices.

>[7] eat pancake
(first taking the pancake)
You eat the pancake. Not bad.

Bart the Bartender tends to the prepared plates.

>[8] eat egg
(first taking the egg)
You eat the egg. Not bad.

Bart the Bartender tends to the beer taps.

A scientist arrives from Offices.

>[9] eat bacon
(first taking the slice of bacon)
You eat the slice of bacon. Not bad.

Bart the Bartender tends to the beer taps.

>[10] eat toast
(first taking the slice of toast)
You eat the slice of toast. Not bad.

Bart the Bartender tends to the stovetop.

A scientist heads to Offices.

>[11] drink orange juice.
You drink the orange juice. Refreshing.

Bart the Bartender tends to the pint glasses.

* * *

You awaken.

Antarctic Ruse
An Interactive Fiction by Robert Dionne
Release 1 / Serial number 140406 / Inform 7 build 6G60 (I6/v6.32 lib 6/12N) SD

Sleeping Quarters (on your bunk bed)
You are in your bunk bed in Sleeping Quarters. The smell of warm breakfast wafts through the northern hatch. Your alarm clock buzzes loudly.

On the other bunks are some sleeping crew.

On your night stand are an alarm clock, a keycard and a mobile phone.

On your bunk bed you can see a copy of Research Robotics and some grey fatigues.

>test awaken
(Testing.)

>[1] take all
copy of Research Robotics: Taken.
grey fatigues: Taken.
keycard: Taken.
mobile phone: Taken.

[Your score has just gone up by two points.]

>[2] put on clothes
You put on the grey fatigues.

>[3] turn off alarm
You switch the alarm clock off.

>[4] north.
(first getting off your bunk bed)
(first opening the hatch)

Mess Hall
The Mess Hall is more properly a bar repurposed at mealtimes for eating. East leads to Offices.

On the bar are prepared plates, pint glasses and some beer taps.

You can also see Bart the Bartender here.

Bart the Bartender cleans the pint glasses.

A scientist arrives from Offices.

>look
Mess Hall
The Mess Hall is more properly a bar repurposed at mealtimes for eating. East leads to Offices.

On the bar are prepared plates, pint glasses and some beer taps.

You can also see a scientist and Bart the Bartender here.

Bart the Bartender tends to the stovetop.

>take plate
You take a plate from the bar.

Bart the Bartender prepares the beer taps.

A scientist heads to Offices.

>take glass
You take a pint glass from the bar.

Bart the Bartender cleans the prepared plates.

>turn off bart
You switch Bart the Bartender off.

>look
Mess Hall
The Mess Hall is more properly a bar repurposed at mealtimes for eating. East leads to Offices.

On the bar are prepared plates, pint glasses and some beer taps.

You can also see Bart the Bartender here.

>turn on bart
You switch Bart the Bartender on.

Bart the Bartender scrubs the beer taps.

>look
Mess Hall
The Mess Hall is more properly a bar repurposed at mealtimes for eating. East leads to Offices.

On the bar are prepared plates, pint glasses and some beer taps.

You can also see Bart the Bartender here.

Bart the Bartender tends to the beer taps.

>wait
Time passes.

Bart the Bartender washes the prepared plates.

>wait
Time passes.

Bart the Bartender cleans the beer taps.

>wait
Time passes.

Bart the Bartender prepares the stovetop.

>wait
Time passes.

Bart the Bartender cleans the prepared plates.

>wait
Time passes.

Bart the Bartender tends to the beer taps.

>wait
Time passes.

Bart the Bartender prepares the prepared plates.

>wait
Time passes.

Bart the Bartender cleans the beer taps.

>wait
Time passes.

Bart the Bartender washes the stovetop.

>wait
Time passes.

Bart the Bartender prepares the stovetop.

>wait
Time passes.

Bart the Bartender washes the stovetop.

>wait
Time passes.

Bart the Bartender cleans the stovetop.

>wait
Time passes.

Bart the Bartender tends to the beer taps.

>wait
Time passes.

Bart the Bartender cleans the beer taps.

>wait
Time passes.

Bart the Bartender prepares the pint glasses.

>wait
Time passes.

Bart the Bartender cleans the beer taps.

* * *

>test breakfast
(Testing.)

>[1] take plate
You take a plate from the bar.

Bart the Bartender tends to the beer taps.

>[2] take glass
You take a pint glass from the bar.

Bart the Bartender tends to the beer taps.

A scientist heads to Offices.

>[3] eat pancake
(first taking the pancake)
You eat the pancake. Not bad.

Bart the Bartender tends to the pint glasses.

>[4] eat egg
(first taking the egg)
You eat the egg. Not bad.

Bart the Bartender tends to the stovetop.

>[5] eat bacon
(first taking the slice of bacon)
You eat the slice of bacon. Not bad.

Bart the Bartender tends to the stovetop.

>[6] eat toast
(first taking the slice of toast)
You eat the slice of toast. Not bad.

Bart the Bartender tends to the beer taps.

>[7] drink orange juice
You drink the orange juice. Refreshing.

Bart the Bartender tends to the beer taps.

>[8] drop plate and glass
prepared plate: Dropped.
pint glass: Dropped.

Bart the Bartender tends to the prepared plates.

>[9] turn off bart
You switch Bart the Bartender off.

>[10] east.

Offices
You pass through Offices, with Catwalk to the north and Operations to the east.

You can see a computer terminal (closed) here.

A scientist arrives from Catwalk.

>i
You are carrying:
  a pint glass
  a prepared plate
  a mobile phone
  a keycard
  some grey fatigues (being worn)
  a copy of Research Robotics

* * *

You awaken.

Antarctic Ruse
An Interactive Fiction by Robert Dionne
Release 1 / Serial number 140406 / Inform 7 build 6G60 (I6/v6.32 lib 6/12N) SD

Sleeping Quarters (on your bunk bed)
You are in your bunk bed in Sleeping Quarters. The smell of warm breakfast wafts through the northern hatch. Your alarm clock buzzes loudly.

On the other bunks are some sleeping crew.

On your night stand are an alarm clock, a keycard and a mobile phone.

On your bunk bed you can see a copy of Research Robotics and some grey fatigues.

>test me
(Testing.)

>[1] take all
copy of Research Robotics: Taken.
grey fatigues: Taken.
keycard: mobile phone: [Your score has just gone up by two points.]

>[2] put on clothes
You put on the grey fatigues.

>[3] turn off alarm
You switch the alarm clock off.

>[4] go north.
(first getting off your bunk bed)
(first opening the hatch)

Mess Hall
The Mess Hall is more properly a bar repurposed at mealtimes for eating. East leads to Offices.

On the bar are prepared plates, pint glasses and some beer taps.

You can also see Bart the Bartender here.

Bart the Bartender tends to the prepared plates.

A scientist arrives from Offices.