You awaken.

Antarctic Ruse
An Interactive Fiction by Robert Dionne
Release 1 / Serial number 140406 / Inform 7 build 6G60 (I6/v6.32 lib 6/12N) SD

Sleeping Quarters (on your bunk bed)
You are in your bunk bed in Sleeping Quarters. The smell of warm breakfast wafts through the northern hatch. Your alarm clock buzzes loudly.

On the other bunks are some sleeping crew.

On your night stand are an alarm clock, a keycard and a mobile phone.

On your bunk bed you can see a copy of Research Robotics and some grey fatigues.

>take all
copy of Research Robotics: Taken.
grey fatigues: Taken.
keycard: Taken.
mobile phone: Taken.

[Your score has just gone up by two points.]

>drop keycard
Dropped.

>take keycard
Taken.

[Your score has just gone up by one point.]

* * *

You awaken.

Antarctic Ruse
An Interactive Fiction by Robert Dionne
Release 1 / Serial number 140406 / Inform 7 build 6G60 (I6/v6.32 lib 6/12N) SD

Sleeping Quarters (on your bunk bed)
You are in your bunk bed in Sleeping Quarters. The smell of warm breakfast wafts through the northern hatch. Your alarm clock buzzes loudly.

On the other bunks are some sleeping crew.

On your night stand are an alarm clock, a keycard and a mobile phone.

On your bunk bed you can see a copy of Research Robotics and some grey fatigues.

>score
You have so far scored 0 out of a possible 6, in 1 turn.

>test awaken
(Testing.)

>[1] take all
copy of Research Robotics: Taken.
grey fatigues: Taken.
keycard: Taken.
mobile phone: Taken.

[Your score has just gone up by two points.]

>[2] put on clothes
You put on the grey fatigues.

>[3] turn off alarm
You switch the alarm clock off.

>[4] north.
(first getting off your bunk bed)
(first opening the hatch)

Mess Hall
The Mess Hall is more properly a bar repurposed at mealtimes for eating, and west of Offices.

On the bar are prepared plates, pint glasses and some beer taps.

You can also see Bart the Bartender here.

Bart the Bartender cleans the prepared plates.

A scientist arrives from Offices.

>score
You have so far scored 2 out of a possible 6, in 5 turns.

>e
Offices
You pass through Offices, with Catwalk to the north and Operations to the east.

You can see a computer terminal (closed) here.

Your mobile phone buzzes.

>w
Mess Hall
The Mess Hall is more properly a bar repurposed at mealtimes for eating, and west of Offices.

On the bar are prepared plates, pint glasses and some beer taps.

You can also see a scientist and Bart the Bartender here.

Bart the Bartender prepares the stovetop.

Your mobile phone buzzes.

A scientist heads to Offices.

>e
Offices
You pass through Offices, with Catwalk to the north and Operations to the east.

You can see a scientist and a computer terminal (closed) here.

Your mobile phone buzzes.

>n
Catwalk
Your shoes jingle along the metal surface between the railings leading west to Ready Room and east to Garage.

Your mobile phone buzzes.

>w
Ready Room
Your gear is stored in the lockers. Housing Unit to west, Catwalk east.

You can see some lockers (closed) here.

Your mobile phone buzzes.

>w
Housing Unit
You can see Humanoid 1, Humanoid 2 and Humanoid 4 here.

Your mobile phone buzzes.

* * *

You awaken.

Antarctic Ruse
An Interactive Fiction by Robert Dionne
Release 1 / Serial number 140406 / Inform 7 build 6G60 (I6/v6.32 lib 6/12N) SD

Sleeping Quarters (on your bunk bed)
You are in your bunk bed in Sleeping Quarters. The smell of warm breakfast wafts through the northern hatch. Your alarm clock buzzes loudly.

On the other bunks are some sleeping crew.

On your night stand are an alarm clock, a keycard and a mobile phone.

On your bunk bed you can see a copy of Research Robotics and some grey fatigues.

>take keycard
Taken.

>north
You should probably get dressed first!

>open hatch
You open the hatch.

>look
Sleeping Quarters (on your bunk bed)
You are in your bunk bed in Sleeping Quarters. The smell of warm breakfast wafts through the northern hatch. Your alarm clock buzzes loudly.

On the other bunks are some sleeping crew.

On your night stand are an alarm clock and a mobile phone.

On your bunk bed you can see a copy of Research Robotics and some grey fatigues.

>talk to crew
That's not a verb I recognize.

>say hi
(to the sleeping crew)
There is no reply.

>put on fatigues
(first taking the grey fatigues)
You put on the grey fatigues.

>north
A dozing crew member whispers abruptly, "Could you shut that thing off!"

>turn off alarm
You switch the alarm clock off.

>look
Sleeping Quarters (on your bunk bed)
You are in your bunk bed in Sleeping Quarters. The smell of warm breakfast wafts through the northern hatch.

On the other bunks are some sleeping crew.

On your night stand are an alarm clock and a mobile phone.

On your bunk bed you can see a copy of Research Robotics.

>north
You need your mobile phone before starting your shift.

>take mobile phone
Taken.

>north
(first getting off your bunk bed)

Mess Hall
The Mess Hall is more properly a bar repurposed at mealtimes for eating, and west of Offices.

On the bar are prepared plates, pint glasses and some beer taps.

You can also see Bart the Bartender here.

Bart the Bartender washes the beer taps.

A scientist arrives from Offices.

>south
Best not to disturb those that are sleeping.

Bart the Bartender scrubs the prepared plates.

>take a prepared plate
You take a plate from the bar.

Bart the Bartender tends to the stovetop.

A scientist heads to Offices.

>i
You are carrying:
  a prepared plate
    an egg
    a pancake
    a slice of bacon
    a slice of toast
  a mobile phone
  some grey fatigues (being worn)
  a keycard

Bart the Bartender scrubs the beer taps.

>take glass
You take a pint glass from the bar.

Bart the Bartender washes the prepared plates.

A scientist arrives from Offices.

>i
You are carrying:
  a pint glass
    some orange juice
  a prepared plate
    an egg
    a pancake
    a slice of bacon
    a slice of toast
  a mobile phone
  some grey fatigues (being worn)
  a keycard

Bart the Bartender tends to the pint glasses.

>drink orange juice
You drink the orange juice. Refreshing.

Bart the Bartender prepares the beer taps.

A scientist heads to Offices.

>eat egg then eat pancake then eat bacon then eat toast
(first taking the egg)
You eat the egg. Not bad.

Bart the Bartender tends to the stovetop.

(first taking the pancake)
You eat the pancake. Not bad.

Bart the Bartender scrubs the beer taps.

(first taking the slice of bacon)
You eat the slice of bacon. Not bad.

Bart the Bartender prepares the pint glasses.

(first taking the slice of toast)
You eat the slice of toast. Not bad.

Bart the Bartender scrubs the beer taps.

>i
You are carrying:
  a pint glass
  a prepared plate
  a mobile phone
  some grey fatigues (being worn)
  a keycard

Bart the Bartender prepares the beer taps.

>drop glass then drop plate
Dropped.

Bart the Bartender washes the stovetop.

A scientist arrives from Offices.

Dropped.

Bart the Bartender cleans the beer taps.

>i
You are carrying:
  a mobile phone
  some grey fatigues (being worn)
  a keycard

Bart the Bartender washes the stovetop.

A scientist heads to Offices.

>look
Mess Hall
The Mess Hall is more properly a bar repurposed at mealtimes for eating, and west of Offices.

On the bar are prepared plates, pint glasses and some beer taps.

You can also see a prepared plate (empty), a pint glass (empty) and Bart the Bartender here.

Bart the Bartender scrubs the beer taps.

>e
Offices
You pass through Offices, with Catwalk to the north and Operations to the east.

You can see a scientist and a computer terminal (closed) here.

Your mobile phone buzzes.

A scientist heads to Operations.

>open terminal
It seems to be locked.

Your mobile phone buzzes.

>read mobile phone
Text message: "Today's duties:
- Check status of robots on computer terminal in Offices.
- Activate robot workers in Housing Unit.
- Gear up in Ready Room."

A scientist arrives from Operations.

>unlock terminal
What do you want to unlock the computer terminal with?

>i
You are carrying:
  a mobile phone
  some grey fatigues (being worn)
  a keycard

>unlock terminal with keycard
You unlock the computer terminal.

A scientist heads to Mess Hall.

>look
Offices
You pass through Offices, with Catwalk to the north and Operations to the east.

You can see a computer terminal (closed) here.

>open terminal
You open the computer terminal, revealing ROBOTS file.

A scientist arrives from Mess Hall.

>read ROBOTS file
Robot Locations
Humanoid 1 Housing Unit
Humanoid 2 Housing Unit
Humanoid 3 UNKNOWN
Humanoid 4 Housing Unit

>look
Offices
You pass through Offices, with Catwalk to the north and Operations to the east.

You can see a scientist and a computer terminal (in which is ROBOTS file) here.

A scientist heads to Operations.

>east
Operations
The clicks and beeps of the supercomputer here match the blinking lights and gauges. West to Offices.

You can see a scientist and a supercomputer here.

Your mobile phone buzzes.

>look at supercomputer
This machine guides all the research here at Antarctic #57.

The supercomputer is currently switched on.

Your mobile phone buzzes.

A scientist heads to Offices.

>read mobile phone
Text message: "Alert! A Humanoid worker is missing. Investigate Housing Unit."

>look at lights
They flicker faster than you can see.

>look at lights
They blink faster than you can see.

>read gauges
The gauges report outside temperature -55 degrees celsius.

>read gauges
The gauges report outside temperature -15 degrees celsius.

>west
Offices
You pass through Offices, with Catwalk to the north and Operations to the east.

You can see a computer terminal (in which is ROBOTS file) here.

>n
Catwalk
Your shoes clomp along the metal surface between the railings leading west to Ready Room and east to Garage.

>s
Offices
You pass through Offices, with Catwalk to the north and Operations to the east.

You can see a computer terminal (in which is ROBOTS file) here.

>take robots
That's fixed in place.

>look
Offices
You pass through Offices, with Catwalk to the north and Operations to the east.

You can see a computer terminal (in which is ROBOTS file) here.

>n
Catwalk
Your shoes jingle along the metal surface between the railings leading west to Ready Room and east to Garage.

>e
Garage
The SnowCat lies dormant in the Garage. Outside to north.

You can see some empty fuel canisters and SnowCat (empty) here.

>w
Catwalk
Your shoes clomp along the metal surface between the railings leading west to Ready Room and east to Garage.

>e
Garage
The SnowCat lies dormant in the Garage. Outside to north.

You can see some empty fuel canisters and SnowCat (empty) here.

>look at snowcat
A rugged, tracked vehicle with enclosed cab for navigating the treacherous climate outside.

>w
Catwalk
Your shoes clank along the metal surface between the railings leading west to Ready Room and east to Garage.

>w
Ready Room
Your gear is stored in the lockers. Housing Unit to west, Catwalk east.

You can see some lockers (closed) here.

>w
Housing Unit
You can see Humanoid 1, Humanoid 2 and Humanoid 4 here.

>look at Humanoid I
You can't see any such thing.

>look at Humanoid 1
The eyes look dead.

>turn on Humanoid 1
The humanoid twitches for a second, but collapses after blowing a fuse.

>e
Ready Room
Your gear is stored in the lockers. Housing Unit to west, Catwalk east.

You can see some lockers (closed) here.

Your mobile phone buzzes.

>open lockers
You open the lockers, revealing some thick outdoor gear and an EMP grenade.

Your mobile phone buzzes.

>take gear
Taken.

Your mobile phone buzzes.

>wear gear
You put on the thick outdoor gear.

Your mobile phone buzzes.

>i
You are carrying:
  some thick outdoor gear (being worn)
  a mobile phone (providing light)
  some grey fatigues (being worn)
  a keycard

Your mobile phone buzzes.

>take grenade
Taken.

Your mobile phone buzzes.

>read phone
Text message: "Urgent! Suit up in Ready Room. Track down rogue Humanoid 3 outside via Garage."

>w
Housing Unit
You can see Humanoid 1, Humanoid 2 and Humanoid 4 here.

>e
Ready Room
Your gear is stored in the lockers. Housing Unit to west, Catwalk east.

You can see some lockers (empty) here.

>e
Catwalk
Your shoes jingle along the metal surface between the railings leading west to Ready Room and east to Garage.

>e
Garage
The SnowCat lies dormant in the Garage. Outside to north.

You can see some empty fuel canisters and SnowCat (empty) here.

>enter snowcat
You get into SnowCat.

>n
Grid 0-1 (in SnowCat)
Leaving the garage behind, you plow into the hazardous wind and ice.

>e
Grid 0-2 (in SnowCat)
It's hard to tell which way to go.

>e
Off the Grid (in SnowCat)
You are off the known grid and wandering the frigid plains.

You can see a scientist here.

Running out of gas.

>undo
Grid 0-2
[Previous turn undone.]

>n
Grid 1-2 (in SnowCat)
The ice crunches beneath you.

>n
You can't go that way.

>w
Grid 1-1 (in SnowCat)
Icy mist blows eastward at 183 kph.

>w
Grid 1-0 (in SnowCat)
The wind is howling.

>w
Off the Grid (in SnowCat)
You are off the known grid and wandering the frozen plains.

You can see a scientist here.

The gas meter is getting lower.

>n
Off the Grid (in SnowCat)
You are off the known grid and wandering the icy plains.

You can see a scientist here.

You won't be able to drive much farther.

A scientist heads to Off the Grid.
A scientist arrives from Off the Grid.

>w
Off the Grid (in SnowCat)
You are off the known grid and wandering the frozen plains.

You can see a scientist here.

The gas meter is getting lower.

>s
Off the Grid (in SnowCat)
You are off the known grid and wandering the frigid plains.

You can see a scientist here.

Running out of gas.

A scientist heads to Off the Grid.
A scientist arrives from Off the Grid.

>e
Off the Grid (in SnowCat)
You are off the known grid and wandering the glacial plains.

You can see a scientist here.

The gas meter is getting lower.

SnowCat is out of fuel!

>e
SnowCat is out of fuel!

A scientist heads to Off the Grid.
A scientist arrives from Off the Grid.

>exit
You get out of SnowCat.

Off the Grid
You are off the known grid and wandering the frigid plains.

You can see a scientist and SnowCat (empty) here.

You are getting cold.

>n
Off the Grid
You are off the known grid and wandering the glacial plains.

You can see a scientist and SnowCat (empty) here.

A scientist heads to Off the Grid.
A scientist arrives from Off the Grid.

Brrrrrrr.

>w
Off the Grid
You are off the known grid and wandering the frigid plains.

You can see a scientist and SnowCat (empty) here.

It's kinda cold out here.

>e
Off the Grid
You are off the known grid and wandering the frozen plains.

You can see a scientist and SnowCat (empty) here.

A scientist heads to Off the Grid.
A scientist arrives from Off the Grid.

You are getting cold.

>s
Off the Grid
You are off the known grid and wandering the glacial plains.

You can see a scientist and SnowCat (empty) here.

You can't feel your toes.

    *** You have died of hypothermia. ***

In that game you scored 0 out of a possible 0, in 87 turns.

Would you like to RESTART, RESTORE a saved game, QUIT or UNDO the last command?

* * *

>n
You can't go that way.

A scientist heads to Housing Unit.

>look
Ready Room
Your gear is stored in the lockers. Housing Unit to west, Catwalk east.

You can see some lockers (empty) here.

>east
Catwalk
Your shoes clomp along the metal surface between the railings leading west to Ready Room and east to Garage.

>e
Garage
The SnowCat lies dormant in the Garage. Outside to north.

You can see some empty fuel canisters and SnowCat (empty) here.

>enter cat
You get into SnowCat.

>n
Grid 0-1 (in SnowCat)
Leaving the garage behind, you plow into the hazardous wind and ice.

>w
Grid 0-0 (in SnowCat)
You see nothing particular besides complete whiteness.

>n
Grid 1-0 (in SnowCat)
The wind is howling.

>e
Grid 1-1 (in SnowCat)
Icy mist blows eastward at 91 kph.

>n
Grid 2-1 (in SnowCat)
You see the horizon intermittently.

>w
Grid 2-0 (in SnowCat)
Crunching along, you are about halfway to the caves.

>n
Grid 3-0 (in SnowCat)
The wind whistles past the entrances to the Ice Cave and Ice Cavern.

>exit
You get out of SnowCat.

Grid 3-0
The wind whistles past the entrances to the Ice Cave and Ice Cavern.

You can see SnowCat (empty) here.

>w
Darkness
It is pitch dark, and you can't see a thing.

>e
Grid 3-0
The wind whistles past the entrances to the Ice Cave and Ice Cavern.

You can see SnowCat (empty) here.

>e
Grid 3-1
The wind increases its strength.

>e
Grid 3-2
The wind cups the edge of the Ice Crevasse.

>e
Ice Crevasse
The Ice Crevasse engulfs you into its depths.

    *** You died in the fall. ***

In that game you scored 0 out of a possible 0, in 53 turns.

Would you like to RESTART, RESTORE a saved game, QUIT or UNDO the last command?

* * *

You awaken.

Antarctic Ruse
An Interactive Fiction by Robert Dionne
Release 1 / Serial number 140406 / Inform 7 build 6G60 (I6/v6.32 lib 6/12N) SD

Sleeping Quarters (on your bunk bed)
You are in your bunk bed in Sleeping Quarters. The smell of warm breakfast wafts through the northern hatch. Your alarm clock buzzes loudly.

On the other bunks are some sleeping crew.

On your night stand are an alarm clock, a keycard and a mobile phone.

On your bunk bed you can see a copy of Research Robotics and some grey fatigues.

>test awaken
(Testing.)

>[1] take all
copy of Research Robotics: Taken.
grey fatigues: Taken.
keycard: Taken.
mobile phone: Taken.

>[2] put on clothes
You put on the grey fatigues.

>[3] turn off alarm
You switch the alarm clock off.

>[4] north.
(first getting off your bunk bed)
(first opening the hatch)

Mess Hall
The Mess Hall is more properly a bar repurposed at mealtimes for eating, and west of Offices.

On the bar are prepared plates, pint glasses and some beer taps.

You can also see Bart the Bartender here.

Bart the Bartender cleans the prepared plates.

A scientist arrives from Offices.

>n
You can't go that way.

Bart the Bartender cleans the stovetop.

>e
Offices
You pass through Offices, with Catwalk to the north and Operations to the east.

You can see a computer terminal (closed) here.

Your mobile phone buzzes.

A scientist arrives from Catwalk.

>n
Catwalk
Your shoes clomp along the metal surface between the railings leading west to Ready Room and east to Garage.

Your mobile phone buzzes.

>e
Garage
The SnowCat lies dormant in the Garage. Outside to north.

You can see some empty fuel canisters and SnowCat (empty) here.

Your mobile phone buzzes.

>enter snowcat
You get into SnowCat.

Your mobile phone buzzes.

>n
Grid 0-1 (in SnowCat)
Leaving the garage behind, you plow into the hazardous wind and ice.

Your mobile phone buzzes.

>w
Grid 0-0 (in SnowCat)
You see nothing particular besides complete whiteness.

Your mobile phone buzzes.

>w
Off the Grid (in SnowCat)
You are off the known grid and wandering the frigid plains.

You won't be able to drive much farther.

Your mobile phone buzzes.

>n
Off the Grid (in SnowCat)
You are off the known grid and wandering the glacial plains.

The fuel is low.

Your mobile phone buzzes.

* * *

>n
Grid 0-1 (in SnowCat)
Leaving the garage behind, you plow into the hazardous wind and ice.

Your mobile phone buzzes.

>e
Grid 0-2 (in SnowCat)
It's hard to tell which way to go.

Your mobile phone buzzes.

>n
Grid 1-2 (in SnowCat)
The ice crunches beneath you.

Your mobile phone buzzes.

>w
Grid 1-1 (in SnowCat)
Icy mist blows westward at 181 kph.

Your mobile phone buzzes.

>n
Grid 2-1 (in SnowCat)
You see the horizon intermittently.

Your mobile phone buzzes.

>e
Grid 2-2 (in SnowCat)
White everywhere.

Your mobile phone buzzes.

>n
Grid 3-2 (in SnowCat)
The wind cups the edge of the Ice Crevasse.

Your mobile phone buzzes.

>exit
You get out of SnowCat.

Grid 3-2
The wind cups the edge of the Ice Crevasse.

You can see SnowCat (empty) here.

Your mobile phone buzzes.

You are getting cold.

>e
Ice Crevasse
The Ice Crevasse engulfs you into its depths.

Your mobile phone buzzes.

It's kinda cold out here.

>look
Ice Crevasse
The Ice Crevasse engulfs you into its depths.

Your mobile phone buzzes.

You can't feel your toes.

>w
Grid 3-2
The wind cups the edge of the Ice Crevasse.

You can see SnowCat (empty) here.

Your mobile phone buzzes.

You are getting cold.

>e
Ice Crevasse
The Ice Crevasse engulfs you into its depths.

Your mobile phone buzzes.

Brrrrrrr.

    *** You have died of hypothermia. ***

In that game you scored 2 out of a possible 0, in 21 turns.

Would you like to RESTART, RESTORE a saved game, QUIT or UNDO the last command?

* * *

>n
Grid 3-2 (in SnowCat)
The wind cups the edge of the Ice Crevasse.

Your mobile phone buzzes.

>look
Grid 3-2 (in SnowCat)
The wind cups the edge of the Ice Crevasse.

Your mobile phone buzzes.

>exit
You get out of SnowCat.

Grid 3-2
The wind cups the edge of the Ice Crevasse.

You can see SnowCat (empty) here.

Your mobile phone buzzes.

You are getting cold.

>e
    *** You died in the fall. ***

In that game you scored 2 out of a possible 0, in 19 turns.

Would you like to RESTART, RESTORE a saved game, QUIT or UNDO the last command?

* * *

>n
Catwalk
Your shoes clomp along the metal surface between the railings leading west to Ready Room and east to Garage.

Your mobile phone buzzes.

>w
Ready Room
Your gear is stored in the lockers. Housing Unit to west, Catwalk east.

You can see some lockers (closed) here.

Your mobile phone buzzes.

>open lockers
You open the lockers, revealing some thick outdoor gear and an EMP grenade.

Your mobile phone buzzes.

>take all
thick outdoor gear: Taken.
EMP grenade: Taken.

Your mobile phone buzzes.

>wear gear
You put on the thick outdoor gear.

Your mobile phone buzzes.

>e
Catwalk
Your shoes jingle along the metal surface between the railings leading west to Ready Room and east to Garage.

Your mobile phone buzzes.

>e
Garage
The SnowCat lies dormant in the Garage. Outside to north.

You can see some empty fuel canisters and SnowCat (empty) here.

Your mobile phone buzzes.

>enter cat
You get into SnowCat.

Your mobile phone buzzes.

>n
Grid 0-1 (in SnowCat)
Leaving the garage behind, you plow into the hazardous wind and ice.

Your mobile phone buzzes.

* * *

>w
Grid 0-0 (in SnowCat)
You see nothing particular besides complete whiteness.

Your mobile phone buzzes.

>n
Grid 1-0 (in SnowCat)
The wind is howling.

Your mobile phone buzzes.

>e
Grid 1-1 (in SnowCat)
Icy mist blows eastward at 194 kph.

Your mobile phone buzzes.

>n
Grid 2-1 (in SnowCat)
You see the horizon intermittently.

Your mobile phone buzzes.

>w
Grid 2-0 (in SnowCat)
Crunching along, you are about halfway to the caves.

Your mobile phone buzzes.

>n
Grid 3-0 (in SnowCat)
The wind whistles past the entrances to the Ice Cave and Ice Cavern.

Your mobile phone buzzes.

>exit
You get out of SnowCat.

Grid 3-0
The wind whistles past the entrances to the Ice Cave and Ice Cavern.

You can see SnowCat (empty) here.

Your mobile phone buzzes.

>n
Ice Cave
The rogue robot Humanoid 3 is waiting here.

You can see Humanoid 3 here.

Your mobile phone buzzes.

>look at humanoid 3
Humanoid 3 is clearly disturbed and autonomous.

Your mobile phone buzzes.

    *** You toss the EMP grenade and it explodes, disabling Humanoid 3. You win! ***

In that game you scored 0 out of a possible 0, in 24 turns.

Would you like to RESTART, RESTORE a saved game, QUIT or UNDO the last command?

* * *

>e
Offices
You pass through Offices, with Catwalk to the north and Operations to the east.

You can see a computer terminal (closed) here.

Your mobile phone buzzes.

>n
Catwalk
Your shoes jingle along the metal surface between the railings leading west to Ready Room and east to Garage.

Your mobile phone buzzes.

>e
Garage
The SnowCat lies dormant in the Garage. Outside to north.

You can see some empty fuel canisters and SnowCat (empty) here.

Your mobile phone buzzes.

* * *

>n
Grid 1-2 (in SnowCat)
The ice crunches beneath you.

Your mobile phone buzzes.

>w
Grid 1-1 (in SnowCat)
Icy mist blows westward at 122 kph.

Your mobile phone buzzes.

>n
Grid 2-1 (in SnowCat)
You see the horizon intermittently.

Your mobile phone buzzes.

* * *

>exit
You get out of SnowCat.

Grid 3-2
The wind cups the edge of the Ice Crevasse.

You can see SnowCat (empty) here.

Your mobile phone buzzes.

You are getting cold.

>e
    *** You died in the fall. ***

In that game you scored 2 out of a possible 0, in 17 turns.

Would you like to RESTART, RESTORE a saved game, QUIT or UNDO the last command?

* * *

>e
Garage
The SnowCat lies dormant in the Garage. Outside to north.

You can see some empty fuel canisters and SnowCat (empty) here.

Your mobile phone buzzes.

>w
Catwalk
Your shoes bang along the metal surface between the railings leading west to Ready Room and east to Garage.

Your mobile phone buzzes.

>w
Ready Room
Your gear is stored in the lockers. Housing Unit to west, Catwalk east.

You can see some lockers (closed) here.

Your mobile phone buzzes.

* * *

>open lockers
You open the lockers, revealing some thick outdoor gear and an EMP grenade.

Your mobile phone buzzes.

>put on gear
(first taking the thick outdoor gear)
You put on the thick outdoor gear.

Your mobile phone buzzes.

>e
Catwalk
Your shoes clank along the metal surface between the railings leading west to Ready Room and east to Garage.

Your mobile phone buzzes.

A scientist arrives from Offices.

>e
Garage
The SnowCat lies dormant in the Garage. Outside to north.

You can see some empty fuel canisters and SnowCat (empty) here.

Your mobile phone buzzes.

* * *

>n
Catwalk
Your shoes jingle along the metal surface between the railings leading west to Ready Room and east to Garage.

Your mobile phone buzzes.

I beg your pardon?

>e
Garage
The SnowCat lies dormant in the Garage. Outside to north.

You can see some empty fuel canisters and SnowCat (empty) here.

Your mobile phone buzzes.

* * *

>n
Grid 1-2 (in SnowCat)
The ice crunches beneath you.

Your mobile phone buzzes.

>w
Grid 1-1 (in SnowCat)
Icy mist blows westward at 109 kph.

Your mobile phone buzzes.

>n
Grid 2-1 (in SnowCat)
You see the horizon intermittently.

Your mobile phone buzzes.

* * *

>n
Grid 3-2 (in SnowCat)
The wind cups the edge of the Ice Crevasse.

Your mobile phone buzzes.

>exit
You get out of SnowCat.

Grid 3-2
The wind cups the edge of the Ice Crevasse.

You can see SnowCat (empty) here.

Your mobile phone buzzes.

Brrrrrrr.

>e
Ice Crevasse
The Ice Crevasse engulfs you into its depths.

    *** You died in the fall. ***

In that game you scored 2 out of a possible 0, in 17 turns.

Would you like to RESTART, RESTORE a saved game, QUIT or UNDO the last command?

* * *

>w
Housing Unit
You can see Humanoid 1, Humanoid 2 and Humanoid 4 here.

Your mobile phone buzzes.

>x Humanoid 1
The eyes look dead.

Your mobile phone buzzes.

[Your score has just gone up by one point.]

>x Humanoid 2
The face is smashed.

Your mobile phone buzzes.

[Your score has just gone up by one point.]

>x Humanoid 3
You can't see any such thing.

>x Humanoid 4
The antennae are bent.

Your mobile phone buzzes.

[Your score has just gone up by one point.]

>score
You have so far scored 5 out of a possible 0, in 12 turns.

* * *

>wear gear
You put on the thick outdoor gear.

Your mobile phone buzzes.

>e
Catwalk
Your shoes clomp along the metal surface between the railings leading west to Ready Room and east to Garage.

Your mobile phone buzzes.

>drop emp
Dropped.

Your mobile phone buzzes.

>e
Garage
The SnowCat lies dormant in the Garage. Outside to north.

You can see some empty fuel canisters and SnowCat (empty) here.

Your mobile phone buzzes.

* * *

>n
Grid 1-0 (in SnowCat)
The wind is howling.

Your mobile phone buzzes.

>e
Grid 1-1 (in SnowCat)
Icy mist blows westward at 89 kph.

Your mobile phone buzzes.

>n
Grid 2-1 (in SnowCat)
You see the horizon intermittently.

Your mobile phone buzzes.

* * *

>n
Ice Cave
The rogue robot Humanoid 3 is waiting here.

You can see Humanoid 3 here.

Your mobile phone buzzes.

>look at Humanoid 3
Humanoid 3 is clearly disturbed and autonomous.

Your mobile phone buzzes.

    *** You forgot the EMP grenade and Humanoid 3 ambushes you, killing you under his weight. ***

In that game you scored 0 out of a possible 0, in 24 turns.

Would you like to RESTART, RESTORE a saved game, QUIT or UNDO the last command?

* * *

>put on gear
(first taking the thick outdoor gear)
You put on the thick outdoor gear.

Your mobile phone buzzes.

>take emp
Taken.

Your mobile phone buzzes.

>e
Catwalk
Your shoes clank along the metal surface between the railings leading west to Ready Room and east to Garage.

Your mobile phone buzzes.

>e
Garage
The SnowCat lies dormant in the Garage. Outside to north.

You can see some empty fuel canisters and SnowCat (empty) here.

Your mobile phone buzzes.

>enter vehicle
You get into SnowCat.

Your mobile phone buzzes.

>n
Grid 0-1 (in SnowCat)
Leaving the garage behind, you plow into the hazardous wind and ice.

Your mobile phone buzzes.

* * *

>n
Grid 1-2 (in SnowCat)
The ice crunches beneath you.

Your mobile phone buzzes.

>w
Grid 1-1 (in SnowCat)
Icy mist blows eastward at 174 kph.

Your mobile phone buzzes.

>n
Grid 2-1 (in SnowCat)
You see the horizon intermittently.

Your mobile phone buzzes.

* * *

>n
Grid 3-2 (in SnowCat)
The wind cups the edge of the Ice Crevasse.

Your mobile phone buzzes.

>w
Grid 3-1 (in SnowCat)
The wind increases its strength.

Your mobile phone buzzes.

>w
Grid 3-0 (in SnowCat)
The wind whistles past the entrances to the Ice Cave and Ice Cavern.

Your mobile phone buzzes.

>n
You cannot drive SnowCat into Ice Cave.

Your mobile phone buzzes.

>exit
You get out of SnowCat.

Grid 3-0
The wind whistles past the entrances to the Ice Cave and Ice Cavern.

You can see SnowCat (empty) here.

Your mobile phone buzzes.

>n
    *** You toss the EMP grenade and it explodes, disabling Humanoid 3. You win! ***

In that game you scored 0 out of a possible 0, in 25 turns.

Would you like to RESTART, RESTORE a saved game, QUIT or UNDO the last command?

* * *

>score
You have so far scored 2 out of a possible 8, in 5 turns.

>e
Offices
You pass through Offices, with Catwalk to the north and Operations to the east.

You can see a computer terminal (closed) here.

Your mobile phone buzzes.

>n
Catwalk
Your shoes clomp along the metal surface between the railings leading west to Ready Room and east to Garage.

You can see a scientist here.

Your mobile phone buzzes.

A scientist heads to Ready Room.

>w
Ready Room
Your gear is stored in the lockers. Housing Unit to west, Catwalk east.

You can see a scientist and some lockers (closed) here.

Your mobile phone buzzes.

>w
Housing Unit
You can see Humanoid 1, Humanoid 2 and Humanoid 4 here.

Your mobile phone buzzes.

A scientist arrives from Ready Room.

>x Humanoid 1
The eyes look dead.

Your mobile phone buzzes.

[Your score has just gone up by one point.]

>x humanoid 2
The face is smashed.

Your mobile phone buzzes.

A scientist heads to Ready Room.

[Your score has just gone up by one point.]

>x humanoid 3
You can't see any such thing.

>x humanoid 4
The antennae are bent.

Your mobile phone buzzes.

[Your score has just gone up by one point.]

>score
You have so far scored 5 out of a possible 8, in 12 turns.

>e
Ready Room
Your gear is stored in the lockers. Housing Unit to west, Catwalk east.

You can see a scientist and some lockers (closed) here.

Your mobile phone buzzes.

A scientist heads to Catwalk.

>open lockers
You open the lockers, revealing some thick outdoor gear and an EMP grenade.

Your mobile phone buzzes.

>take all
thick outdoor gear: Taken.
EMP grenade: Taken.

Your mobile phone buzzes.

[Your score has just gone up by two points.]

>wear gear
You put on the thick outdoor gear.

Your mobile phone buzzes.

* * *

You awaken.

Antarctic Ruse
An Interactive Fiction by Robert Dionne
Release 1 / Serial number 140406 / Inform 7 build 6G60 (I6/v6.32 lib 6/12N) SD

Sleeping Quarters (on your bunk bed)
You are in your bunk bed in Sleeping Quarters. The smell of warm breakfast wafts through the northern hatch. Your alarm clock buzzes loudly.

On the other bunks are some sleeping crew.

On your night stand are an alarm clock, a keycard and a mobile phone.

On your bunk bed you can see a copy of Research Robotics and some grey fatigues.

>enter snowcat
You can't see any such thing.

>test awaken
(Testing.)

>[1] take all
copy of Research Robotics: Taken.
grey fatigues: Taken.
keycard: Taken.
mobile phone: Taken.

[Your score has just gone up by two points.]

>[2] put on clothes
You put on the grey fatigues.

>[3] turn off alarm
You switch the alarm clock off.

>[4] north.
(first getting off your bunk bed)
(first opening the hatch)

Mess Hall
The Mess Hall is more properly a bar repurposed at mealtimes for eating, and west of Offices.

On the bar are prepared plates, pint glasses and some beer taps.

You can also see Bart the Bartender here.

Bart the Bartender cleans the stovetop.

>e
Offices
You pass through Offices, with Catwalk to the north and Operations to the east.

You can see a computer terminal (closed) here.

Your mobile phone buzzes.

* * *

>n
Grid 0-1 (in SnowCat)
Leaving the garage behind, you plow into the hazardous wind and ice.

Your mobile phone buzzes.

>read phone
Text message: "Today's duties:
- Check status of robots on computer terminal in Offices.
- Activate robot workers in Housing Unit.
- Gear up in Ready Room."

>w
Grid 0-0 (in SnowCat)
You see nothing particular besides complete whiteness.

* * *

>n
Grid 1-0 (in SnowCat)
The wind is howling.

>e
Grid 1-1 (in SnowCat)
Icy mist blows westward at 136 kph.

>exit
You get out of SnowCat.

Grid 1-1
Icy mist blows eastward at 118 kph.

You can see SnowCat (empty) here.

HAHA
Brrrrrrr.

>e
Grid 1-2
The ice crunches beneath you.

You can't feel your toes.

>s
Grid 0-2
It's hard to tell which way to go.

Brrrrrrr.

>e
Off the Grid
You are off the known grid and wandering the frozen plains.

It's kinda cold out here.

>w
Off the Grid
You are off the known grid and wandering the glacial plains.

Brrrrrrr.

    *** You have died of hypothermia. ***

In that game you scored 2 out of a possible 0, in 18 turns.

Would you like to RESTART, RESTORE a saved game, QUIT or UNDO the last command?